,gender,year,country,gold,silver,bronze,total
0,male,1896,United States,1229,1000,876,3105
1,male,1896,Soviet Union,473,376,355,1204
2,male,1896,Germany,384,419,408,1211
3,male,1896,People's Republic of China,384,281,235,900
4,male,1896,Great Britain,325,352,359,1036
5,male,1896,France,312,335,392,1039
6,male,1896,Italy,299,278,308,885
7,male,1896,Russian Federation,290,243,246,779
8,male,1896,Sweden,233,245,262,740
9,male,1896,Japan,229,220,241,690
10,male,1896,Norway,221,205,191,617
11,male,1896,Hungary,210,183,208,601
12,male,1896,East Germany,192,165,162,519
13,male,1896,Australia,185,204,247,636
14,male,1896,Republic of Korea,166,144,137,447
15,male,1896,Netherlands,159,166,187,512
16,male,1896,Canada,157,197,250,604
17,male,1896,Finland,155,157,195,507
18,male,1896,Switzerland,142,146,153,441
19,male,1896,Elis,117,0,0,117
20,male,1896,Austria,113,138,161,412
21,male,1896,Cuba,99,73,87,259
22,male,1896,Romania,98,107,127,332
23,male,1896,Poland,89,99,158,346
24,male,1896,Sparta,83,0,0,83
25,male,1896,West Germany,67,82,94,243
26,male,1896,Bulgaria,61,96,89,246
27,male,1896,New Zealand,61,40,59,160
28,male,1896,Ukraine,60,63,102,225
29,male,1896,Belgium,55,68,79,202
30,male,1896,Denmark,54,89,89,232
31,male,1896,Spain,54,82,72,208
32,male,1896,Unified Team,54,44,37,135
33,male,1896,Athens,53,0,0,53
34,male,1896,Mixed team,52,48,56,156
35,male,1896,Czechoslovakia,51,58,62,171
36,male,1896,Alexandria,49,0,0,49
37,male,1896,Greece,47,63,59,169
38,male,1896,Brazil,47,55,80,182
39,male,1896,Türkiye,45,34,55,134
40,male,1896,Kenya,43,45,40,128
41,male,1896,Rhodes,38,0,0,38
42,male,1896,Czechia,36,46,53,135
43,male,1896,Islamic Republic of Iran,36,28,37,101
44,male,1896,Unknown,36,0,0,36
45,male,1896,Argentina,34,36,45,115
46,male,1896,South Africa,33,39,34,106
47,male,1896,Jamaica,30,38,27,95
48,male,1896,Ethiopia,30,20,29,79
49,male,1896,ROC,28,46,46,120
50,male,1896,Belarus,26,48,52,126
51,male,1896,Yugoslavia,26,32,29,87
52,male,1896,Miletus,26,0,0,26
53,male,1896,Kazakhstan,24,31,53,108
54,male,1896,Ephesus,24,0,0,24
55,male,1896,Kroton,23,0,0,23
56,male,1896,Messene,23,0,0,23
57,male,1896,Slovenia,22,27,36,85
58,male,1896,Croatia,22,22,19,63
59,male,1896,Thailand,21,18,22,61
60,male,1896,Argos,21,0,0,21
61,male,1896,Siracusa,21,0,0,21
62,male,1896,Democratic People's Republic of Korea,20,20,27,67
63,male,1896,Azerbaijan,19,24,32,75
64,male,1896,Sikyon,19,0,0,19
65,male,1896,Uzbekistan,17,16,33,66
66,male,1896,Kyrene,17,0,0,17
67,male,1896,Magnesia on the Maiandros,17,0,0,17
68,male,1896,Mexico,16,33,52,101
69,male,1896,Slovakia,16,25,16,57
70,male,1896,Megara,16,0,0,16
71,male,1896,Egypt,15,15,32,62
72,male,1896,Estonia,15,13,20,48
73,male,1896,Aigion,15,0,0,15
74,male,1896,Korinth,14,0,0,14
75,male,1896,India,13,25,20,58
76,male,1896,Lithuania,13,10,17,40
77,male,1896,Macedonia,13,0,0,13
78,male,1896,Pellene,13,0,0,13
79,male,1896,Roma,13,0,0,13
80,male,1896,Colombia,12,20,21,53
81,male,1896,Ireland,12,14,19,45
82,male,1896,Thessaly,12,0,0,12
83,male,1896,Georgia,11,18,22,51
84,male,1896,Epidauros,11,0,0,11
85,male,1896,Chinese Taipei,10,18,22,50
86,male,1896,Heraia,10,0,0,10
87,male,1896,Morocco,9,10,15,34
88,male,1896,Kos,9,0,0,9
89,male,1896,Lakonia (Akrion),9,0,0,9
90,male,1896,Philadelphia,9,0,0,9
91,male,1896,Samos,9,0,0,9
92,male,1896,Smyrna,9,0,0,9
93,male,1896,Taranto,9,0,0,9
94,male,1896,Thebes,9,0,0,9
95,male,1896,Latvia,8,18,17,43
96,male,1896,Indonesia,8,14,18,40
97,male,1896,The Bahamas,8,3,8,19
98,male,1896,Antiochia on the Orontes,8,0,0,8
99,male,1896,Lepreon,8,0,0,8
100,male,1896,Manteneia,8,0,0,8
101,male,1896,Salamis,8,0,0,8
102,male,1896,Thespiai,8,0,0,8
103,male,1896,Xanthos,8,0,0,8
104,male,1896,Serbia,7,11,15,33
105,male,1896,Israel,7,5,11,23
106,male,1896,Khios,7,0,0,7
107,male,1896,Korkyra,7,0,0,7
108,male,1896,Kyzikos,7,0,0,7
109,male,1896,Larisa,7,0,0,7
110,male,1896,Mainalos,7,0,0,7
111,male,1896,Nigeria,6,14,15,35
112,male,1896,Portugal,6,13,16,35
113,male,1896,Tunisia,6,5,9,20
114,male,1896,Himera,6,0,0,6
115,male,1896,Sardis,6,0,0,6
116,male,1896,Seleukeia on the Tigris,6,0,0,6
117,male,1896,Unknown city in Crete,6,0,0,6
118,male,1896,Unknown city in Lokria,6,0,0,6
119,male,1896,Venezuela,5,15,14,34
120,male,1896,Armenia,5,11,15,31
121,male,1896,Algeria,5,9,8,22
122,male,1896,Dominican Republic,5,6,6,17
123,male,1896,Vietnam,5,6,3,14
124,male,1896,Uganda,5,5,5,15
125,male,1896,Akragas,5,0,0,5
126,male,1896,Ambrakia,5,0,0,5
127,male,1896,Bithynia (Nikaia),5,0,0,5
128,male,1896,Pharsalos,5,0,0,5
129,male,1896,Phoenicia,5,0,0,5
130,male,1896,Sinope,5,0,0,5
131,male,1896,Thourioi,5,0,0,5
132,male,1896,Mongolia,4,14,18,36
133,male,1896,Trinidad and Tobago,4,6,12,22
134,male,1896,Ecuador,4,5,2,11
135,male,1896,Qatar,4,3,4,11
136,male,1896,Kleitor,4,0,0,4
137,male,1896,Lindos,4,0,0,4
138,male,1896,Mytilene,4,0,0,4
139,male,1896,Naxos,4,0,0,4
140,male,1896,Opous,4,0,0,4
141,male,1896,Pergamon,4,0,0,4
142,male,1896,Phigaleia,4,0,0,4
143,male,1896,Sidon,4,0,0,4
144,male,1896,Syria (Antocheia),4,0,0,4
145,male,1896,Tralles,4,0,0,4
146,male,1896,Chile,3,7,4,14
147,male,1896,Singapore,3,5,6,14
148,male,1896,Luxembourg,3,5,0,8
149,male,1896,Republic of Moldova,3,4,6,13
150,male,1896,Australasia,3,4,5,12
151,male,1896,Pakistan,3,4,5,12
152,male,1896,Zimbabwe,3,4,1,8
153,male,1896,Puerto Rico,3,3,8,14
154,male,1896,Uruguay,3,2,6,11
155,male,1896,Cameroon,3,1,2,6
156,male,1896,Kosovo,3,0,1,4
157,male,1896,Erythrai,3,0,0,3
158,male,1896,Hermopolis,3,0,0,3
159,male,1896,Kamarina,3,0,0,3
160,male,1896,Keramos,3,0,0,3
161,male,1896,Kolophon,3,0,0,3
162,male,1896,Krannon,3,0,0,3
163,male,1896,Laodikeia on the Lykos,3,0,0,3
164,male,1896,Patrai,3,0,0,3
165,male,1896,Stratonikeia,3,0,0,3
166,male,1896,Tegea,3,0,0,3
167,male,1896,Thyateira,3,0,0,3
168,male,1896,Malaysia,2,11,6,19
169,male,1896,"Hong Kong, China",2,9,6,17
170,male,1896,Serbia and Montenegro,2,4,3,9
171,male,1896,Peru,2,3,2,7
172,male,1896,Bahrain,2,3,1,6
173,male,1896,Liechtenstein,2,2,7,11
174,male,1896,Burundi,2,2,0,4
175,male,1896,Fiji,2,0,2,4
176,male,1896,Suriname,2,0,1,3
177,male,1896,Adana,2,0,0,2
178,male,1896,Aigeira,2,0,0,2
179,male,1896,Aitolia,2,0,0,2
180,male,1896,Andros,2,0,0,2
181,male,1896,Anthedon,2,0,0,2
182,male,1896,Apamea-Myrleia,2,0,0,2
183,male,1896,Aphrodisias,2,0,0,2
184,male,1896,Daldis,2,0,0,2
185,male,1896,Delphi,2,0,0,2
186,male,1896,Dymai,2,0,0,2
187,male,1896,Elateia,2,0,0,2
188,male,1896,Epidamnos,2,0,0,2
189,male,1896,Gela,2,0,0,2
190,male,1896,Halicarnassus,2,0,0,2
191,male,1896,Hyblaia,2,0,0,2
192,male,1896,Khalkis,2,0,0,2
193,male,1896,Methydria,2,0,0,2
194,male,1896,Parrhasia,2,0,0,2
195,male,1896,Poseidonia,2,0,0,2
196,male,1896,Stymphalia,2,0,0,2
197,male,1896,Sybaris,2,0,0,2
198,male,1896,Tanagra,2,0,0,2
199,male,1896,Tarsos,2,0,0,2
200,male,1896,Tenedos,2,0,0,2
201,male,1896,Thasos,2,0,0,2
202,male,1896,Troy,2,0,0,2
203,male,1896,Tyana,2,0,0,2
204,male,1896,Unknown city in Arkadia,2,0,0,2
205,male,1896,Unknown city in Boeotia,2,0,0,2
206,male,1896,Unknown city in Egypt,2,0,0,2
207,male,1896,Philippines,1,6,8,15
208,male,1896,Kyrgyzstan,1,6,7,14
209,male,1896,Kingdom of Saudi Arabia,1,2,5,8
210,male,1896,Iceland,1,2,3,6
211,male,1896,Jordan,1,2,3,6
212,male,1896,Tajikistan,1,2,3,6
213,male,1896,Zambia,1,2,2,5
214,male,1896,Ghana,1,1,4,6
215,male,1896,Independent Olympic Athletes,1,1,3,5
216,male,1896,Costa Rica,1,1,2,4
217,male,1896,Côte d'Ivoire,1,1,2,4
218,male,1896,Grenada,1,1,2,4
219,male,1896,Syrian Arab Republic,1,1,2,4
220,male,1896,United Arab Emirates,1,1,1,3
221,male,1896,United States Virgin Islands,1,1,0,2
222,male,1896,Eritrea,1,0,3,4
223,male,1896,Panama,1,0,2,3
224,male,1896,Bermuda,1,0,1,2
225,male,1896,Mauritius,1,0,1,2
226,male,1896,Mozambique,1,0,1,2
227,male,1896,Adai,1,0,0,1
228,male,1896,Adramyttion,1,0,0,1
229,male,1896,Aizanoi,1,0,0,1
230,male,1896,Akarnan,1,0,0,1
231,male,1896,Amphipolis,1,0,0,1
232,male,1896,Amphissa,1,0,0,1
233,male,1896,Anemurium,1,0,0,1
234,male,1896,Antikyra,1,0,0,1
235,male,1896,Antissa,1,0,0,1
236,male,1896,Apollonia,1,0,0,1
237,male,1896,Armenia,1,0,0,1
238,male,1896,Aspendos,1,0,0,1
239,male,1896,Assos,1,0,0,1
240,male,1896,Astypalaia,1,0,0,1
241,male,1896,Atiolia,1,0,0,1
242,male,1896,Attaleia,1,0,0,1
243,male,1896,Augusta Traiana,1,0,0,1
244,male,1896,Bargylia,1,0,0,1
245,male,1896,Barke,1,0,0,1
246,male,1896,Bithynia (Prousa),1,0,0,1
247,male,1896,Bolivia,1,0,0,1
248,male,1896,Delos,1,0,0,1
249,male,1896,Dipaia,1,0,0,1
250,male,1896,Dyspontion,1,0,0,1
251,male,1896,Epeiros,1,0,0,1
252,male,1896,Gortyn,1,0,0,1
253,male,1896,Hermione,1,0,0,1
254,male,1896,Hierapolis,1,0,0,1
255,male,1896,Hypaipa,1,0,0,1
256,male,1896,Iasos,1,0,0,1
257,male,1896,Kamiros,1,0,0,1
258,male,1896,Kappadokia,1,0,0,1
259,male,1896,Karian,1,0,0,1
260,male,1896,Karystos,1,0,0,1
261,male,1896,Kelonai,1,0,0,1
262,male,1896,Klazomenai,1,0,0,1
263,male,1896,Kleonai,1,0,0,1
264,male,1896,Kydonia,1,0,0,1
265,male,1896,Kyme,1,0,0,1
266,male,1896,Kyparissia,1,0,0,1
267,male,1896,Kypro,1,0,0,1
268,male,1896,Maroneia,1,0,0,1
269,male,1896,Megalopolis,1,0,0,1
270,male,1896,Melos,1,0,0,1
271,male,1896,Mylasa,1,0,0,1
272,male,1896,Myra,1,0,0,1
273,male,1896,Naukratis,1,0,0,1
274,male,1896,Neapolis,1,0,0,1
275,male,1896,Nysa,1,0,0,1
276,male,1896,Oinoanda,1,0,0,1
277,male,1896,Orestheia,1,0,0,1
278,male,1896,Orkhomenos,1,0,0,1
279,male,1896,Oxyrhynchos,1,0,0,1
280,male,1896,Peparethos,1,0,0,1
281,male,1896,Pessinous,1,0,0,1
282,male,1896,Petra,1,0,0,1
283,male,1896,Philippoi,1,0,0,1
284,male,1896,Pisa,1,0,0,1
285,male,1896,Skotoussa,1,0,0,1
286,male,1896,Tauromenion,1,0,0,1
287,male,1896,Telmessos,1,0,0,1
288,male,1896,Tenos,1,0,0,1
289,male,1896,Terina,1,0,0,1
290,male,1896,Thelphoussa,1,0,0,1
291,male,1896,Tiryns,1,0,0,1
292,male,1896,Tlos,1,0,0,1
293,male,1896,Tritaia,1,0,0,1
294,male,1896,Troizen,1,0,0,1
295,male,1896,Unknown city in Asia,1,0,0,1
296,male,1896,Zakynthos,1,0,0,1
297,male,1896,Namibia,0,5,0,5
298,male,1896,Botswana,0,3,1,4
299,male,1896,Cyprus,0,3,0,3
300,male,1896,Lebanon,0,2,3,5
301,male,1896,Haiti,0,2,1,3
302,male,1896,Sri Lanka,0,2,1,3
303,male,1896,United Republic of Tanzania,0,2,0,2
304,male,1896,Bohemia,0,1,5,6
305,male,1896,Niger,0,1,2,3
306,male,1896,North Macedonia,0,1,2,3
307,male,1896,San Marino,0,1,2,3
308,male,1896,Bosnia and Herzegovina,0,1,1,2
309,male,1896,Guatemala,0,1,1,2
310,male,1896,Netherlands Antilles,0,1,1,2
311,male,1896,Turkmenistan,0,1,1,2
312,male,1896,United Arab Republic,0,1,1,2
313,male,1896,El Salvador,0,1,0,1
314,male,1896,Equatorial Guinea,0,1,0,1
315,male,1896,Gabon,0,1,0,1
316,male,1896,Montenegro,0,1,0,1
317,male,1896,Nauru,0,1,0,1
318,male,1896,Paraguay,0,1,0,1
319,male,1896,Saint Lucia,0,1,0,1
320,male,1896,Samoa,0,1,0,1
321,male,1896,Senegal,0,1,0,1
322,male,1896,Sudan,0,1,0,1
323,male,1896,Tonga,0,1,0,1
324,male,1896,Kuwait,0,0,4,4
325,male,1896,Afghanistan,0,0,3,3
326,male,1896,Djibouti,0,0,2,2
327,male,1896,Iraq,0,0,2,2
328,male,1896,Monaco,0,0,2,2
329,male,1896,West Indies Federation,0,0,2,2
330,male,1896,Andorra,0,0,1,1
331,male,1896,Barbados,0,0,1,1
332,male,1896,Burkina Faso,0,0,1,1
333,male,1896,Cambodia,0,0,1,1
334,male,1896,Guyana,0,0,1,1
335,male,1896,Honduras,0,0,1,1
336,male,1896,Togo,0,0,1,1
337,male,1900,United States,647,566,481,1694
338,male,1900,Soviet Union,259,213,199,671
339,male,1900,France,151,159,171,481
340,male,1900,Italy,149,115,143,407
341,male,1900,Great Britain,141,149,161,451
342,male,1900,Sweden,133,130,153,416
343,male,1900,Norway,131,110,115,356
344,male,1900,Germany,127,148,164,439
345,male,1900,Finland,119,111,125,355
346,male,1900,Japan,117,110,127,354
347,male,1900,Hungary,100,97,101,298
348,male,1900,Russian Federation,97,57,99,253
349,male,1900,People's Republic of China,94,75,70,239
350,male,1900,Cuba,67,42,53,162
351,male,1900,Switzerland,65,69,63,197
352,male,1900,East Germany,62,49,74,185
353,male,1900,Australia,61,70,75,206
354,male,1900,Republic of Korea,58,69,68,195
355,male,1900,Poland,58,44,89,191
356,male,1900,Netherlands,55,60,60,175
357,male,1900,Austria,53,65,75,193
358,male,1900,Canada,50,72,86,208
359,male,1900,Bulgaria,40,59,52,151
360,male,1900,Türkiye,39,23,30,92
361,male,1900,Czechoslovakia,32,32,36,100
362,male,1900,Unified Team,30,22,15,67
363,male,1900,Belgium,29,34,38,101
364,male,1900,Greece,28,32,31,91
365,male,1900,Kenya,27,27,28,82
366,male,1900,West Germany,26,40,42,108
367,male,1900,Islamic Republic of Iran,24,23,28,75
368,male,1900,Romania,23,34,56,113
369,male,1900,New Zealand,23,8,31,62
370,male,1900,Ukraine,19,19,28,66
371,male,1900,Spain,18,27,22,67
372,male,1900,South Africa,17,20,20,57
373,male,1900,Denmark,16,42,36,94
374,male,1900,Brazil,16,18,35,69
375,male,1900,Yugoslavia,14,14,19,47
376,male,1900,Czechia,13,15,15,43
377,male,1900,Ethiopia,13,7,12,32
378,male,1900,Kazakhstan,12,20,26,58
379,male,1900,Argentina,11,16,13,40
380,male,1900,Jamaica,11,12,7,30
381,male,1900,ROC,11,11,25,47
382,male,1900,Georgia,10,12,17,39
383,male,1900,Estonia,10,9,14,33
384,male,1900,Democratic People's Republic of Korea,10,8,16,34
385,male,1900,Uzbekistan,10,6,19,35
386,male,1900,Mexico,9,16,18,43
387,male,1900,Belarus,7,19,24,50
388,male,1900,Egypt,7,9,13,29
389,male,1900,Azerbaijan,6,11,19,36
390,male,1900,Morocco,6,4,10,20
391,male,1900,Ireland,5,7,13,25
392,male,1900,Slovenia,4,10,8,22
393,male,1900,Thailand,4,5,7,16
394,male,1900,Tunisia,4,3,5,12
395,male,1900,Latvia,3,12,6,21
396,male,1900,Croatia,3,10,6,19
397,male,1900,Slovakia,3,9,5,17
398,male,1900,Algeria,3,4,7,14
399,male,1900,Portugal,3,4,5,12
400,male,1900,Uganda,3,4,3,10
401,male,1900,Luxembourg,3,4,0,7
402,male,1900,Lithuania,3,3,5,11
403,male,1900,Dominican Republic,3,3,2,8
404,male,1900,Mongolia,2,9,13,24
405,male,1900,Armenia,2,8,8,18
406,male,1900,India,2,6,7,15
407,male,1900,Venezuela,2,6,6,14
408,male,1900,Indonesia,2,5,7,14
409,male,1900,Trinidad and Tobago,2,4,9,15
410,male,1900,Qatar,2,2,3,7
411,male,1900,Ecuador,2,1,0,3
412,male,1900,Israel,2,0,6,8
413,male,1900,Colombia,1,8,8,17
414,male,1900,Chile,1,5,3,9
415,male,1900,Chinese Taipei,1,4,5,10
416,male,1900,Serbia,1,2,4,7
417,male,1900,Vietnam,1,2,1,4
418,male,1900,Peru,1,2,0,3
419,male,1900,Grenada,1,1,1,3
420,male,1900,Jordan,1,1,1,3
421,male,1900,Tajikistan,1,1,1,3
422,male,1900,Côte d'Ivoire,1,1,0,2
423,male,1900,Singapore,1,1,0,2
424,male,1900,Independent Olympic Athletes,1,0,2,3
425,male,1900,Panama,1,0,2,3
426,male,1900,The Bahamas,1,0,2,3
427,male,1900,Suriname,1,0,1,2
428,male,1900,United Arab Emirates,1,0,1,2
429,male,1900,Burundi,1,0,0,1
430,male,1900,"Hong Kong, China",1,0,0,1
431,male,1900,Malaysia,0,4,2,6
432,male,1900,Namibia,0,4,0,4
433,male,1900,Philippines,0,3,8,11
434,male,1900,Australasia,0,3,5,8
435,male,1900,Nigeria,0,3,4,7
436,male,1900,Puerto Rico,0,2,6,8
437,male,1900,Kyrgyzstan,0,2,3,5
438,male,1900,Lebanon,0,2,2,4
439,male,1900,Uruguay,0,2,2,4
440,male,1900,Kingdom of Saudi Arabia,0,2,1,3
441,male,1900,United Republic of Tanzania,0,2,0,2
442,male,1900,Republic of Moldova,0,1,4,5
443,male,1900,Ghana,0,1,3,4
444,male,1900,Liechtenstein,0,1,3,4
445,male,1900,Syrian Arab Republic,0,1,2,3
446,male,1900,Bohemia,0,1,1,2
447,male,1900,Cameroon,0,1,1,2
448,male,1900,Iceland,0,1,1,2
449,male,1900,Niger,0,1,1,2
450,male,1900,North Macedonia,0,1,1,2
451,male,1900,United Arab Republic,0,1,1,2
452,male,1900,Zambia,0,1,1,2
453,male,1900,Botswana,0,1,0,1
454,male,1900,Cyprus,0,1,0,1
455,male,1900,Gabon,0,1,0,1
456,male,1900,Guatemala,0,1,0,1
457,male,1900,Haiti,0,1,0,1
458,male,1900,Netherlands Antilles,0,1,0,1
459,male,1900,Senegal,0,1,0,1
460,male,1900,Sri Lanka,0,1,0,1
461,male,1900,Sudan,0,1,0,1
462,male,1900,Tonga,0,1,0,1
463,male,1900,United States Virgin Islands,0,1,0,1
464,male,1900,Kuwait,0,0,3,3
465,male,1900,Afghanistan,0,0,2,2
466,male,1900,Pakistan,0,0,2,2
467,male,1900,Barbados,0,0,1,1
468,male,1900,Bermuda,0,0,1,1
469,male,1900,Burkina Faso,0,0,1,1
470,male,1900,Djibouti,0,0,1,1
471,male,1900,Eritrea,0,0,1,1
472,male,1900,Guyana,0,0,1,1
473,male,1900,Iraq,0,0,1,1
474,male,1900,Mauritius,0,0,1,1
475,male,1900,Monaco,0,0,1,1
476,male,1900,San Marino,0,0,1,1
477,male,1900,Togo,0,0,1,1
478,male,1900,West Indies Federation,0,0,1,1
479,male,1904,France,21,22,22,65
480,male,1904,United States,18,13,12,43
481,male,1904,Great Britain,8,6,7,21
482,male,1904,Belgium,6,4,5,15
483,male,1904,Italy,3,2,0,5
484,male,1904,Switzerland,3,1,1,5
485,male,1904,Denmark,1,3,2,6
486,male,1904,Hungary,1,2,2,5
487,male,1904,Cuba,1,1,0,2
488,male,1904,Germany,1,1,0,2
489,male,1904,Austria,0,3,3,6
490,male,1904,India,0,2,0,2
491,male,1904,Norway,0,1,3,4
492,male,1904,Bohemia,0,1,0,1
493,male,1904,Australia,0,0,3,3
494,male,1904,Netherlands,0,0,1,1
495,male,1904,Sweden,0,0,1,1
496,male,1908,United States,65,69,69,203
497,male,1908,Germany,5,4,5,14
498,male,1908,Cuba,3,0,0,3
499,male,1908,Hungary,2,1,1,4
500,male,1908,Canada,2,0,0,2
501,male,1908,Great Britain,1,1,0,2
502,male,1908,Greece,1,0,1,2
503,male,1912,Great Britain,30,31,25,86
504,male,1912,United States,20,11,11,42
505,male,1912,Sweden,6,3,8,17
506,male,1912,France,2,5,5,12
507,male,1912,Hungary,2,3,1,6
508,male,1912,Canada,2,2,5,9
509,male,1912,Germany,2,2,4,8
510,male,1912,Italy,2,1,0,3
511,male,1912,Norway,1,2,3,6
512,male,1912,Russian Federation,1,2,0,3
513,male,1912,Finland,1,1,2,4
514,male,1912,Belgium,1,1,1,3
515,male,1912,South Africa,1,1,0,2
516,male,1912,Greece,0,3,1,4
517,male,1912,Australasia,0,2,2,4
518,male,1912,Denmark,0,1,3,4
519,male,1912,Austria,0,0,1,1
520,male,1912,Bohemia,0,0,1,1
521,male,1920,United States,21,17,15,53
522,male,1920,Sweden,11,14,14,39
523,male,1920,Finland,9,5,6,20
524,male,1920,Germany,4,10,4,18
525,male,1920,France,4,3,1,8
526,male,1920,Italy,4,1,2,7
527,male,1920,Canada,3,2,3,8
528,male,1920,South Africa,3,2,0,5
529,male,1920,Great Britain,2,6,5,13
530,male,1920,Hungary,2,1,3,6
531,male,1920,Belgium,1,1,2,4
532,male,1920,Greece,1,0,1,2
533,male,1920,Denmark,0,2,2,4
534,male,1920,Australasia,0,1,3,4
535,male,1920,Russian Federation,0,1,2,3
536,male,1920,Norway,0,1,1,2
537,male,1920,Austria,0,0,1,1
538,male,1924,United States,23,21,20,64
539,male,1924,Sweden,13,14,15,42
540,male,1924,Finland,13,9,7,29
541,male,1924,Belgium,9,5,8,22
542,male,1924,Italy,8,4,4,16
543,male,1924,France,6,9,6,21
544,male,1924,Great Britain,5,7,10,22
545,male,1924,Norway,4,3,5,12
546,male,1924,South Africa,3,1,2,6
547,male,1924,Canada,2,3,3,8
548,male,1924,Switzerland,1,2,3,6
549,male,1924,Estonia,1,2,0,3
550,male,1924,Brazil,1,1,0,2
551,male,1924,Netherlands,1,0,2,3
552,male,1924,Denmark,0,7,1,8
553,male,1924,Australia,0,1,1,2
554,male,1924,Japan,0,1,0,1
555,male,1924,Luxembourg,0,1,0,1
556,male,1924,New Zealand,0,0,1,1
557,male,1928,United States,27,19,18,64
558,male,1928,Finland,12,13,9,34
559,male,1928,France,9,7,9,25
560,male,1928,Great Britain,6,6,7,19
561,male,1928,Switzerland,5,6,7,18
562,male,1928,Italy,5,2,2,9
563,male,1928,Sweden,3,10,6,19
564,male,1928,Belgium,3,3,2,8
565,male,1928,Australia,3,0,2,5
566,male,1928,Hungary,2,2,3,7
567,male,1928,Norway,2,1,3,6
568,male,1928,Netherlands,2,1,1,4
569,male,1928,Yugoslavia,2,0,0,2
570,male,1928,Czechoslovakia,1,4,5,10
571,male,1928,Denmark,1,4,2,7
572,male,1928,Estonia,1,1,4,6
573,male,1928,South Africa,1,1,1,3
574,male,1928,Luxembourg,1,1,0,2
575,male,1928,Greece,1,0,0,1
576,male,1928,Argentina,0,3,2,5
577,male,1928,Austria,0,3,1,4
578,male,1928,Ireland,0,1,1,2
579,male,1928,Canada,0,0,1,1
580,male,1928,Japan,0,0,1,1
581,male,1928,Monaco,0,0,1,1
582,male,1928,New Zealand,0,0,1,1
583,male,1928,Poland,0,0,1,1
584,male,1932,United States,11,12,12,35
585,male,1932,Finland,8,8,9,25
586,male,1932,Sweden,7,5,6,18
587,male,1932,France,6,9,5,20
588,male,1932,Germany,5,7,13,25
589,male,1932,Switzerland,5,5,4,14
590,male,1932,Netherlands,4,4,3,11
591,male,1932,Hungary,4,4,0,8
592,male,1932,Italy,3,4,5,12
593,male,1932,Great Britain,3,3,2,8
594,male,1932,Argentina,3,2,0,5
595,male,1932,Austria,3,0,0,3
596,male,1932,Czechoslovakia,2,4,2,8
597,male,1932,Canada,2,2,3,7
598,male,1932,Denmark,2,1,4,7
599,male,1932,Egypt,2,1,1,4
600,male,1932,Estonia,2,1,1,4
601,male,1932,Japan,2,0,1,3
602,male,1932,Australia,1,2,1,4
603,male,1932,Yugoslavia,1,1,2,4
604,male,1932,Poland,1,0,1,2
605,male,1932,South Africa,1,0,1,2
606,male,1932,Ireland,1,0,0,1
607,male,1932,Luxembourg,1,0,0,1
608,male,1932,New Zealand,1,0,0,1
609,male,1932,Belgium,0,1,1,2
610,male,1932,Norway,0,1,1,2
611,male,1932,Chile,0,1,0,1
612,male,1932,Haiti,0,1,0,1
613,male,1932,Philippines,0,0,1,1
614,male,1936,United States,25,26,21,72
615,male,1936,Italy,9,7,10,26
616,male,1936,Sweden,9,4,7,20
617,male,1936,Japan,6,5,4,15
618,male,1936,France,6,4,3,13
619,male,1936,Finland,5,8,11,24
620,male,1936,Hungary,4,5,3,12
621,male,1936,Germany,3,7,6,16
622,male,1936,Great Britain,3,3,1,7
623,male,1936,Argentina,3,1,0,4
624,male,1936,Canada,2,2,4,8
625,male,1936,Netherlands,2,2,1,5
626,male,1936,Australia,2,0,1,3
627,male,1936,South Africa,2,0,1,3
628,male,1936,Ireland,2,0,0,2
629,male,1936,Poland,2,0,0,2
630,male,1936,Czechoslovakia,1,3,2,6
631,male,1936,Denmark,0,4,1,5
632,male,1936,Mexico,0,2,0,2
633,male,1936,Austria,0,1,3,4
634,male,1936,Latvia,0,1,0,1
635,male,1936,Switzerland,0,1,0,1
636,male,1936,Philippines,0,0,3,3
637,male,1936,Belgium,0,0,1,1
638,male,1936,Spain,0,0,1,1
639,male,1936,Uruguay,0,0,1,1
640,male,1948,Germany,22,21,21,64
641,male,1948,United States,17,17,8,42
642,male,1948,Finland,8,6,5,19
643,male,1948,Hungary,6,1,3,10
644,male,1948,France,5,4,2,11
645,male,1948,Sweden,5,3,7,15
646,male,1948,Italy,4,8,5,17
647,male,1948,Japan,4,4,10,18
648,male,1948,Austria,4,3,2,9
649,male,1948,Switzerland,3,6,3,12
650,male,1948,Estonia,2,2,3,7
651,male,1948,Netherlands,2,1,3,6
652,male,1948,Egypt,2,1,2,5
653,male,1948,Czechoslovakia,1,4,1,6
654,male,1948,Great Britain,1,3,1,5
655,male,1948,Argentina,1,1,2,4
656,male,1948,Canada,1,1,2,4
657,male,1948,Norway,1,1,1,3
658,male,1948,Türkiye,1,0,1,2
659,male,1948,New Zealand,1,0,0,1
660,male,1948,Poland,0,1,3,4
661,male,1948,Latvia,0,1,1,2
662,male,1948,Romania,0,1,0,1
663,male,1948,South Africa,0,1,0,1
664,male,1948,Yugoslavia,0,1,0,1
665,male,1948,Denmark,0,0,2,2
666,male,1948,Australia,0,0,1,1
667,male,1948,Belgium,0,0,1,1
668,male,1948,Mexico,0,0,1,1
669,male,1948,Philippines,0,0,1,1
670,male,1952,United States,23,21,13,57
671,male,1952,Sweden,14,9,14,37
672,male,1952,Finland,8,7,4,19
673,male,1952,Hungary,7,2,9,18
674,male,1952,Italy,6,5,8,19
675,male,1952,Türkiye,6,4,2,12
676,male,1952,Switzerland,5,8,6,19
677,male,1952,France,5,4,8,17
678,male,1952,Czechoslovakia,4,1,3,8
679,male,1952,Argentina,3,1,1,5
680,male,1952,Australia,2,4,2,8
681,male,1952,South Africa,2,2,2,6
682,male,1952,Egypt,2,2,1,5
683,male,1952,Great Britain,1,7,3,11
684,male,1952,Denmark,1,2,4,7
685,male,1952,Belgium,1,2,2,5
686,male,1952,Austria,1,2,1,4
687,male,1952,Jamaica,1,2,0,3
688,male,1952,Mexico,1,1,1,3
689,male,1952,Poland,1,0,1,2
690,male,1952,Peru,1,0,0,1
691,male,1952,Norway,0,2,2,4
692,male,1952,Canada,0,2,1,3
693,male,1952,Netherlands,0,1,4,5
694,male,1952,Sri Lanka,0,1,0,1
695,male,1952,Trinidad and Tobago,0,1,0,1
696,male,1952,Uruguay,0,1,0,1
697,male,1952,Yugoslavia,0,1,0,1
698,male,1952,Panama,0,0,2,2
699,male,1952,Republic of Korea,0,0,2,2
700,male,1952,Islamic Republic of Iran,0,0,1,1
701,male,1952,Puerto Rico,0,0,1,1
702,male,1956,United States,30,16,10,56
703,male,1956,Soviet Union,15,16,12,43
704,male,1956,Sweden,9,8,8,25
705,male,1956,Hungary,6,6,7,19
706,male,1956,Czechoslovakia,5,2,2,9
707,male,1956,Italy,4,6,2,12
708,male,1956,France,3,4,3,10
709,male,1956,Finland,3,3,9,15
710,male,1956,Switzerland,2,3,4,9
711,male,1956,Australia,2,2,1,5
712,male,1956,Türkiye,2,0,1,3
713,male,1956,Norway,2,0,0,2
714,male,1956,Japan,1,5,2,8
715,male,1956,Jamaica,1,3,0,4
716,male,1956,Poland,1,2,1,4
717,male,1956,Romania,1,1,2,4
718,male,1956,Belgium,1,1,0,2
719,male,1956,Canada,1,1,0,2
720,male,1956,Brazil,1,0,2,3
721,male,1956,Denmark,1,0,1,2
722,male,1956,Luxembourg,1,0,0,1
723,male,1956,Germany,0,3,11,14
724,male,1956,Islamic Republic of Iran,0,3,4,7
725,male,1956,Argentina,0,2,2,4
726,male,1956,South Africa,0,1,4,5
727,male,1956,Great Britain,0,1,3,4
728,male,1956,Lebanon,0,1,1,2
729,male,1956,Chile,0,1,0,1
730,male,1956,Ireland,0,1,0,1
731,male,1956,Mexico,0,1,0,1
732,male,1956,Spain,0,1,0,1
733,male,1956,Republic of Korea,0,0,2,2
734,male,1956,Trinidad and Tobago,0,0,2,2
735,male,1956,Bulgaria,0,0,1,1
736,male,1956,Egypt,0,0,1,1
737,male,1956,India,0,0,1,1
738,male,1956,New Zealand,0,0,1,1
739,male,1956,Venezuela,0,0,1,1
740,male,1960,Soviet Union,25,18,22,65
741,male,1960,United States,21,15,13,49
742,male,1960,Japan,4,9,5,18
743,male,1960,Italy,4,5,7,16
744,male,1960,Australia,4,4,6,14
745,male,1960,Romania,4,2,3,9
746,male,1960,Sweden,3,3,5,11
747,male,1960,Great Britain,3,3,4,10
748,male,1960,Türkiye,3,2,2,7
749,male,1960,Finland,3,1,8,12
750,male,1960,France,3,1,3,7
751,male,1960,Hungary,2,6,3,11
752,male,1960,Germany,2,4,1,7
753,male,1960,Islamic Republic of Iran,2,2,1,5
754,male,1960,Bulgaria,1,3,0,4
755,male,1960,Ireland,1,1,3,5
756,male,1960,Norway,1,0,2,3
757,male,1960,Canada,1,0,1,2
758,male,1960,Mexico,1,0,1,2
759,male,1960,Brazil,1,0,0,1
760,male,1960,Denmark,1,0,0,1
761,male,1960,New Zealand,1,0,0,1
762,male,1960,Poland,0,3,3,6
763,male,1960,Czechoslovakia,0,2,1,3
764,male,1960,Belgium,0,2,0,2
765,male,1960,Chile,0,1,2,3
766,male,1960,Argentina,0,1,1,2
767,male,1960,Republic of Korea,0,1,1,2
768,male,1960,Iceland,0,1,0,1
769,male,1960,Yugoslavia,0,1,0,1
770,male,1960,South Africa,0,0,3,3
771,male,1960,Greece,0,0,1,1
772,male,1964,Soviet Union,25,18,22,65
773,male,1964,United States,21,15,13,49
774,male,1964,Japan,4,9,5,18
775,male,1964,Italy,4,5,7,16
776,male,1964,Australia,4,4,6,14
777,male,1964,Romania,4,2,3,9
778,male,1964,Sweden,3,3,5,11
779,male,1964,Great Britain,3,3,4,10
780,male,1964,Türkiye,3,2,2,7
781,male,1964,Finland,3,1,8,12
782,male,1964,France,3,1,3,7
783,male,1964,Hungary,2,6,3,11
784,male,1964,Germany,2,4,1,7
785,male,1964,Islamic Republic of Iran,2,2,1,5
786,male,1964,Bulgaria,1,3,0,4
787,male,1964,Ireland,1,1,3,5
788,male,1964,Norway,1,0,2,3
789,male,1964,Canada,1,0,1,2
790,male,1964,Mexico,1,0,1,2
791,male,1964,Brazil,1,0,0,1
792,male,1964,Denmark,1,0,0,1
793,male,1964,New Zealand,1,0,0,1
794,male,1964,Poland,0,3,3,6
795,male,1964,Czechoslovakia,0,2,1,3
796,male,1964,Belgium,0,2,0,2
797,male,1964,Chile,0,1,2,3
798,male,1964,Argentina,0,1,1,2
799,male,1964,Republic of Korea,0,1,1,2
800,male,1964,Iceland,0,1,0,1
801,male,1964,Yugoslavia,0,1,0,1
802,male,1964,South Africa,0,0,3,3
803,male,1964,Greece,0,0,1,1
804,male,1968,United States,19,14,17,50
805,male,1968,Soviet Union,15,22,22,59
806,male,1968,Japan,14,5,5,24
807,male,1968,Italy,8,5,5,18
808,male,1968,Poland,6,1,7,14
809,male,1968,Hungary,5,5,3,13
810,male,1968,Germany,3,11,11,25
811,male,1968,Bulgaria,3,5,2,10
812,male,1968,Australia,3,0,4,7
813,male,1968,Finland,3,0,2,5
814,male,1968,Great Britain,2,7,1,10
815,male,1968,Czechoslovakia,2,3,1,6
816,male,1968,Türkiye,2,3,1,6
817,male,1968,Yugoslavia,2,0,2,4
818,male,1968,Belgium,2,0,1,3
819,male,1968,New Zealand,2,0,1,3
820,male,1968,France,1,3,3,7
821,male,1968,Sweden,1,1,2,4
822,male,1968,Switzerland,1,1,1,3
823,male,1968,Ethiopia,1,0,0,1
824,male,1968,Netherlands,1,0,0,1
825,male,1968,Romania,0,3,3,6
826,male,1968,Canada,0,2,1,3
827,male,1968,Republic of Korea,0,2,1,3
828,male,1968,Denmark,0,1,2,3
829,male,1968,Trinidad and Tobago,0,1,1,2
830,male,1968,Tunisia,0,1,1,2
831,male,1968,Argentina,0,1,0,1
832,male,1968,Cuba,0,1,0,1
833,male,1968,Philippines,0,1,0,1
834,male,1968,Islamic Republic of Iran,0,0,2,2
835,male,1968,Ghana,0,0,1,1
836,male,1968,Ireland,0,0,1,1
837,male,1968,Kenya,0,0,1,1
838,male,1968,Mexico,0,0,1,1
839,male,1968,Nigeria,0,0,1,1
840,male,1968,Uruguay,0,0,1,1
841,male,1972,United States,22,18,23,63
842,male,1972,Soviet Union,18,20,13,51
843,male,1972,Japan,10,5,6,21
844,male,1972,Hungary,6,5,6,17
845,male,1972,East Germany,6,2,3,11
846,male,1972,Poland,4,2,7,13
847,male,1972,France,4,2,3,9
848,male,1972,Kenya,3,3,2,8
849,male,1972,Great Britain,3,2,2,7
850,male,1972,Mexico,3,2,2,7
851,male,1972,Australia,3,1,1,5
852,male,1972,Italy,2,3,5,10
853,male,1972,Bulgaria,2,3,3,8
854,male,1972,Islamic Republic of Iran,2,1,2,5
855,male,1972,Türkiye,2,0,0,2
856,male,1972,West Germany,1,7,7,15
857,male,1972,Romania,1,3,3,7
858,male,1972,Finland,1,2,1,4
859,male,1972,Yugoslavia,1,1,2,4
860,male,1972,Ethiopia,1,1,0,2
861,male,1972,Czechoslovakia,1,0,3,4
862,male,1972,Sweden,1,0,1,2
863,male,1972,Tunisia,1,0,1,2
864,male,1972,Netherlands,1,0,0,1
865,male,1972,Venezuela,1,0,0,1
866,male,1972,Denmark,0,3,1,4
867,male,1972,Cuba,0,2,0,2
868,male,1972,Mongolia,0,1,3,4
869,male,1972,Brazil,0,1,1,2
870,male,1972,Republic of Korea,0,1,1,2
871,male,1972,Uganda,0,1,1,2
872,male,1972,Austria,0,1,0,1
873,male,1972,Belgium,0,1,0,1
874,male,1972,Cameroon,0,1,0,1
875,male,1972,Canada,0,1,0,1
876,male,1972,Jamaica,0,1,0,1
877,male,1972,Argentina,0,0,2,2
878,male,1972,New Zealand,0,0,2,2
879,male,1972,Switzerland,0,0,2,2
880,male,1972,Greece,0,0,1,1
881,male,1976,Soviet Union,28,16,12,56
882,male,1976,United States,18,21,21,60
883,male,1976,Japan,10,7,8,25
884,male,1976,East Germany,7,4,11,22
885,male,1976,Bulgaria,6,8,2,16
886,male,1976,Hungary,5,6,12,23
887,male,1976,Poland,5,3,6,14
888,male,1976,West Germany,4,5,7,16
889,male,1976,Sweden,3,3,5,11
890,male,1976,Italy,3,2,6,11
891,male,1976,Romania,3,2,3,8
892,male,1976,Finland,3,1,3,7
893,male,1976,Cuba,3,1,1,5
894,male,1976,Netherlands,3,0,0,3
895,male,1976,France,2,3,4,9
896,male,1976,Czechoslovakia,2,1,0,3
897,male,1976,Norway,2,0,0,2
898,male,1976,Australia,1,4,0,5
899,male,1976,Kenya,1,3,4,8
900,male,1976,Great Britain,1,2,8,11
901,male,1976,Democratic People's Republic of Korea,1,1,2,4
902,male,1976,Yugoslavia,1,1,2,4
903,male,1976,Uganda,1,1,0,2
904,male,1976,Denmark,1,0,0,1
905,male,1976,Islamic Republic of Iran,0,2,1,3
906,male,1976,Belgium,0,2,0,2
907,male,1976,Greece,0,2,0,2
908,male,1976,Colombia,0,1,2,3
909,male,1976,Austria,0,1,1,2
910,male,1976,Argentina,0,1,0,1
911,male,1976,Canada,0,1,0,1
912,male,1976,Lebanon,0,1,0,1
913,male,1976,Mexico,0,1,0,1
914,male,1976,Mongolia,0,1,0,1
915,male,1976,Republic of Korea,0,1,0,1
916,male,1976,Switzerland,0,1,0,1
917,male,1976,Tunisia,0,1,0,1
918,male,1976,Türkiye,0,1,0,1
919,male,1976,Brazil,0,0,2,2
920,male,1976,Ethiopia,0,0,2,2
921,male,1976,Ghana,0,0,1,1
922,male,1976,Jamaica,0,0,1,1
923,male,1976,New Zealand,0,0,1,1
924,male,1976,Niger,0,0,1,1
925,male,1976,Nigeria,0,0,1,1
926,male,1976,Spain,0,0,1,1
927,male,1980,Soviet Union,30,20,19,69
928,male,1980,United States,25,23,17,65
929,male,1980,East Germany,8,7,12,27
930,male,1980,Japan,7,6,10,23
931,male,1980,Cuba,6,4,2,12
932,male,1980,Poland,5,2,12,19
933,male,1980,West Germany,4,6,10,20
934,male,1980,Finland,4,2,0,6
935,male,1980,Bulgaria,3,6,5,14
936,male,1980,Hungary,2,4,5,11
937,male,1980,Italy,2,2,4,8
938,male,1980,Yugoslavia,2,2,3,7
939,male,1980,Czechoslovakia,2,1,1,4
940,male,1980,Sweden,2,0,0,2
941,male,1980,Romania,1,5,9,15
942,male,1980,France,1,2,3,6
943,male,1980,Great Britain,1,2,3,6
944,male,1980,Republic of Korea,1,1,3,5
945,male,1980,Democratic People's Republic of Korea,1,1,0,2
946,male,1980,Jamaica,1,1,0,2
947,male,1980,New Zealand,1,1,0,2
948,male,1980,Mexico,1,0,1,2
949,male,1980,Trinidad and Tobago,1,0,0,1
950,male,1980,Belgium,0,3,2,5
951,male,1980,Canada,0,3,0,3
952,male,1980,Netherlands,0,2,0,2
953,male,1980,Portugal,0,2,0,2
954,male,1980,Islamic Republic of Iran,0,1,1,2
955,male,1980,Mongolia,0,1,0,1
956,male,1980,Venezuela,0,1,0,1
957,male,1980,Australia,0,0,2,2
958,male,1980,Austria,0,0,1,1
959,male,1980,Bermuda,0,0,1,1
960,male,1980,Brazil,0,0,1,1
961,male,1980,Denmark,0,0,1,1
962,male,1980,Puerto Rico,0,0,1,1
963,male,1980,Switzerland,0,0,1,1
964,male,1980,Thailand,0,0,1,1
965,male,1984,Soviet Union,46,44,26,116
966,male,1984,East Germany,14,11,23,48
967,male,1984,Bulgaria,8,10,11,29
968,male,1984,Cuba,7,7,5,19
969,male,1984,Italy,7,0,2,9
970,male,1984,Hungary,6,7,9,22
971,male,1984,Great Britain,5,4,4,13
972,male,1984,Poland,3,9,10,22
973,male,1984,Sweden,3,2,4,9
974,male,1984,Finland,3,1,2,6
975,male,1984,France,2,5,2,9
976,male,1984,Romania,2,1,6,9
977,male,1984,Ethiopia,2,0,2,4
978,male,1984,Switzerland,2,0,0,2
979,male,1984,Czechoslovakia,1,1,6,8
980,male,1984,Yugoslavia,1,0,2,3
981,male,1984,Denmark,1,0,1,2
982,male,1984,Greece,1,0,1,2
983,male,1984,Belgium,1,0,0,1
984,male,1984,Democratic People's Republic of Korea,0,3,2,5
985,male,1984,Australia,0,2,4,6
986,male,1984,Mongolia,0,2,2,4
987,male,1984,United Republic of Tanzania,0,2,0,2
988,male,1984,Austria,0,1,1,2
989,male,1984,Mexico,0,1,1,2
990,male,1984,Netherlands,0,1,1,2
991,male,1984,Spain,0,1,1,2
992,male,1984,Uganda,0,1,0,1
993,male,1984,Venezuela,0,1,0,1
994,male,1984,Jamaica,0,0,2,2
995,male,1984,Brazil,0,0,1,1
996,male,1984,Guyana,0,0,1,1
997,male,1984,Ireland,0,0,1,1
998,male,1984,Lebanon,0,0,1,1
999,male,1988,United States,42,28,19,89
1000,male,1988,West Germany,11,9,9,29
1001,male,1988,Japan,10,8,10,28
1002,male,1988,People's Republic of China,10,6,5,21
1003,male,1988,Italy,8,4,8,20
1004,male,1988,Republic of Korea,5,4,6,15
1005,male,1988,Canada,4,8,8,20
1006,male,1988,Romania,4,7,8,19
1007,male,1988,France,4,4,8,16
1008,male,1988,Finland,4,1,6,11
1009,male,1988,New Zealand,4,1,1,6
1010,male,1988,Great Britain,3,5,11,19
1011,male,1988,Yugoslavia,3,3,4,10
1012,male,1988,Australia,2,4,4,10
1013,male,1988,Mexico,2,3,1,6
1014,male,1988,Brazil,1,2,2,5
1015,male,1988,Austria,1,1,1,3
1016,male,1988,Kenya,1,0,2,3
1017,male,1988,Netherlands,1,0,1,2
1018,male,1988,Portugal,1,0,1,2
1019,male,1988,Belgium,1,0,0,1
1020,male,1988,Morocco,1,0,0,1
1021,male,1988,Sweden,0,8,4,12
1022,male,1988,Switzerland,0,2,3,5
1023,male,1988,Denmark,0,2,1,3
1024,male,1988,Greece,0,1,1,2
1025,male,1988,Puerto Rico,0,1,1,2
1026,male,1988,Colombia,0,1,0,1
1027,male,1988,Côte d'Ivoire,0,1,0,1
1028,male,1988,Egypt,0,1,0,1
1029,male,1988,Ireland,0,1,0,1
1030,male,1988,Nigeria,0,1,0,1
1031,male,1988,Peru,0,1,0,1
1032,male,1988,Syrian Arab Republic,0,1,0,1
1033,male,1988,Thailand,0,1,0,1
1034,male,1988,Türkiye,0,0,3,3
1035,male,1988,Venezuela,0,0,3,3
1036,male,1988,Algeria,0,0,2,2
1037,male,1988,Cameroon,0,0,1,1
1038,male,1988,Chinese Taipei,0,0,1,1
1039,male,1988,Dominican Republic,0,0,1,1
1040,male,1988,Iceland,0,0,1,1
1041,male,1988,Norway,0,0,1,1
1042,male,1988,Spain,0,0,1,1
1043,male,1988,Zambia,0,0,1,1
1044,male,1992,Soviet Union,33,17,26,76
1045,male,1992,United States,17,18,14,49
1046,male,1992,East Germany,13,14,12,39
1047,male,1992,Republic of Korea,7,7,9,23
1048,male,1992,Bulgaria,7,6,6,19
1049,male,1992,Hungary,7,4,3,14
1050,male,1992,Kenya,5,2,2,9
1051,male,1992,Japan,4,2,4,10
1052,male,1992,Italy,4,2,3,9
1053,male,1992,France,3,3,2,8
1054,male,1992,Czechoslovakia,3,2,1,6
1055,male,1992,West Germany,2,8,8,18
1056,male,1992,Great Britain,2,6,4,12
1057,male,1992,Poland,2,3,7,12
1058,male,1992,Romania,2,2,1,5
1059,male,1992,New Zealand,2,0,5,7
1060,male,1992,Norway,2,0,0,2
1061,male,1992,Australia,1,5,1,7
1062,male,1992,People's Republic of China,1,4,7,12
1063,male,1992,Canada,1,1,2,4
1064,male,1992,Finland,1,1,2,4
1065,male,1992,Brazil,1,1,1,3
1066,male,1992,Yugoslavia,1,1,1,3
1067,male,1992,Denmark,1,1,0,2
1068,male,1992,Türkiye,1,1,0,2
1069,male,1992,Morocco,1,0,2,3
1070,male,1992,Spain,1,0,2,3
1071,male,1992,Austria,1,0,0,1
1072,male,1992,Suriname,1,0,0,1
1073,male,1992,Sweden,0,3,5,8
1074,male,1992,Netherlands,0,1,2,3
1075,male,1992,Chile,0,1,0,1
1076,male,1992,Islamic Republic of Iran,0,1,0,1
1077,male,1992,Netherlands Antilles,0,1,0,1
1078,male,1992,Senegal,0,1,0,1
1079,male,1992,United States Virgin Islands,0,1,0,1
1080,male,1992,Belgium,0,0,2,2
1081,male,1992,Mexico,0,0,2,2
1082,male,1992,Colombia,0,0,1,1
1083,male,1992,Djibouti,0,0,1,1
1084,male,1992,Greece,0,0,1,1
1085,male,1992,Mongolia,0,0,1,1
1086,male,1992,Pakistan,0,0,1,1
1087,male,1992,Philippines,0,0,1,1
1088,male,1992,Switzerland,0,0,1,1
1089,male,1992,Thailand,0,0,1,1
1090,male,1996,Unified Team,28,22,15,65
1091,male,1996,United States,16,18,15,49
1092,male,1996,Germany,10,7,14,31
1093,male,1996,Cuba,10,3,6,19
1094,male,1996,Hungary,6,6,6,18
1095,male,1996,Republic of Korea,5,3,7,15
1096,male,1996,Spain,5,3,1,9
1097,male,1996,France,4,4,7,15
1098,male,1996,Czechoslovakia,4,1,1,6
1099,male,1996,Democratic People's Republic of Korea,4,0,3,7
1100,male,1996,People's Republic of China,3,6,7,16
1101,male,1996,Australia,3,4,3,10
1102,male,1996,Bulgaria,3,4,3,10
1103,male,1996,Italy,3,2,5,10
1104,male,1996,Japan,2,4,5,11
1105,male,1996,Poland,2,4,5,11
1106,male,1996,Kenya,2,4,2,8
1107,male,1996,Canada,2,3,3,8
1108,male,1996,Great Britain,2,2,5,9
1109,male,1996,Türkiye,2,2,1,5
1110,male,1996,Sweden,1,3,3,7
1111,male,1996,Norway,1,2,1,4
1112,male,1996,Finland,1,1,2,4
1113,male,1996,Indonesia,1,1,1,3
1114,male,1996,Morocco,1,1,1,3
1115,male,1996,Brazil,1,1,0,2
1116,male,1996,Ireland,1,1,0,2
1117,male,1996,Greece,1,0,0,1
1118,male,1996,Lithuania,1,0,0,1
1119,male,1996,Switzerland,1,0,0,1
1120,male,1996,Netherlands,0,4,2,6
1121,male,1996,Latvia,0,2,1,3
1122,male,1996,Namibia,0,2,0,2
1123,male,1996,Nigeria,0,2,0,2
1124,male,1996,New Zealand,0,1,4,5
1125,male,1996,Islamic Republic of Iran,0,1,2,3
1126,male,1996,Jamaica,0,1,0,1
1127,male,1996,Mexico,0,1,0,1
1128,male,1996,Peru,0,1,0,1
1129,male,1996,Romania,0,0,4,4
1130,male,1996,Denmark,0,0,2,2
1131,male,1996,Ethiopia,0,0,2,2
1132,male,1996,Algeria,0,0,1,1
1133,male,1996,Belgium,0,0,1,1
1134,male,1996,Croatia,0,0,1,1
1135,male,1996,Independent Olympic Athletes,0,0,1,1
1136,male,1996,Israel,0,0,1,1
1137,male,1996,Mongolia,0,0,1,1
1138,male,1996,Philippines,0,0,1,1
1139,male,1996,Puerto Rico,0,0,1,1
1140,male,1996,Qatar,0,0,1,1
1141,male,1996,Suriname,0,0,1,1
1142,male,1996,Thailand,0,0,1,1
1143,male,1996,The Bahamas,0,0,1,1
1144,male,2000,United States,18,17,11,46
1145,male,2000,Russian Federation,17,8,10,35
1146,male,2000,Germany,8,6,15,29
1147,male,2000,Italy,7,3,4,14
1148,male,2000,People's Republic of China,6,7,5,18
1149,male,2000,Cuba,6,6,4,16
1150,male,2000,Poland,6,3,3,12
1151,male,2000,France,5,3,7,15
1152,male,2000,Greece,4,3,0,7
1153,male,2000,Hungary,4,2,5,11
1154,male,2000,Türkiye,4,1,1,6
1155,male,2000,Ukraine,4,0,7,11
1156,male,2000,Kazakhstan,3,4,4,11
1157,male,2000,Australia,3,2,7,12
1158,male,2000,Switzerland,3,2,0,5
1159,male,2000,Czechia,3,1,2,6
1160,male,2000,New Zealand,3,0,0,3
1161,male,2000,Republic of Korea,2,8,2,12
1162,male,2000,Bulgaria,2,5,3,10
1163,male,2000,Japan,2,2,2,6
1164,male,2000,Norway,2,1,1,4
1165,male,2000,Algeria,2,0,1,3
1166,male,2000,Canada,1,4,3,8
1167,male,2000,Spain,1,4,2,7
1168,male,2000,Kenya,1,3,3,7
1169,male,2000,Brazil,1,1,4,6
1170,male,2000,Democratic People's Republic of Korea,1,1,2,4
1171,male,2000,Belgium,1,1,1,3
1172,male,2000,Islamic Republic of Iran,1,1,1,3
1173,male,2000,Slovakia,1,1,1,3
1174,male,2000,Armenia,1,1,0,2
1175,male,2000,Denmark,1,1,0,2
1176,male,2000,South Africa,1,1,0,2
1177,male,2000,Netherlands,1,0,3,4
1178,male,2000,Thailand,1,0,1,2
1179,male,2000,Burundi,1,0,0,1
1180,male,2000,Ecuador,1,0,0,1
1181,male,2000,Ethiopia,1,0,0,1
1182,male,2000,Belarus,0,5,6,11
1183,male,2000,Great Britain,0,5,4,9
1184,male,2000,Romania,0,2,3,5
1185,male,2000,Finland,0,2,1,3
1186,male,2000,Namibia,0,2,0,2
1187,male,2000,Argentina,0,1,1,2
1188,male,2000,Austria,0,1,1,2
1189,male,2000,Sweden,0,1,1,2
1190,male,2000,Uzbekistan,0,1,1,2
1191,male,2000,Azerbaijan,0,1,0,1
1192,male,2000,Jamaica,0,1,0,1
1193,male,2000,Latvia,0,1,0,1
1194,male,2000,Philippines,0,1,0,1
1195,male,2000,Slovenia,0,1,0,1
1196,male,2000,Tonga,0,1,0,1
1197,male,2000,Zambia,0,1,0,1
1198,male,2000,Georgia,0,0,2,2
1199,male,2000,Morocco,0,0,2,2
1200,male,2000,Trinidad and Tobago,0,0,2,2
1201,male,2000,India,0,0,1,1
1202,male,2000,Israel,0,0,1,1
1203,male,2000,Malaysia,0,0,1,1
1204,male,2000,Mexico,0,0,1,1
1205,male,2000,Mongolia,0,0,1,1
1206,male,2000,Nigeria,0,0,1,1
1207,male,2000,Puerto Rico,0,0,1,1
1208,male,2000,Republic of Moldova,0,0,1,1
1209,male,2000,Tunisia,0,0,1,1
1210,male,2000,Uganda,0,0,1,1
1211,male,2004,Russian Federation,17,10,19,46
1212,male,2004,United States,15,13,13,41
1213,male,2004,Cuba,8,6,4,18
1214,male,2004,People's Republic of China,8,4,5,17
1215,male,2004,France,6,6,5,17
1216,male,2004,Great Britain,6,4,1,11
1217,male,2004,Germany,5,10,8,23
1218,male,2004,Australia,4,10,6,20
1219,male,2004,Italy,4,3,6,13
1220,male,2004,Greece,4,3,1,8
1221,male,2004,Netherlands,4,1,2,7
1222,male,2004,Republic of Korea,3,6,3,12
1223,male,2004,Bulgaria,3,5,2,10
1224,male,2004,Japan,3,2,0,5
1225,male,2004,Poland,3,1,1,5
1226,male,2004,Sweden,3,1,1,5
1227,male,2004,Ethiopia,3,0,2,5
1228,male,2004,Islamic Republic of Iran,3,0,1,4
1229,male,2004,Türkiye,3,0,1,4
1230,male,2004,Kazakhstan,2,4,0,6
1231,male,2004,Kenya,2,3,1,6
1232,male,2004,Hungary,2,2,1,5
1233,male,2004,Spain,2,2,0,4
1234,male,2004,Canada,2,1,3,6
1235,male,2004,Romania,2,1,2,5
1236,male,2004,Norway,2,0,1,3
1237,male,2004,Ukraine,1,5,6,12
1238,male,2004,Czechia,1,3,2,6
1239,male,2004,Uzbekistan,1,1,2,4
1240,male,2004,Finland,1,1,1,3
1241,male,2004,Latvia,1,1,1,3
1242,male,2004,Estonia,1,0,2,3
1243,male,2004,New Zealand,1,0,2,3
1244,male,2004,Azerbaijan,1,0,1,2
1245,male,2004,Thailand,1,0,1,2
1246,male,2004,Austria,1,0,0,1
1247,male,2004,Croatia,1,0,0,1
1248,male,2004,Lithuania,1,0,0,1
1249,male,2004,Slovenia,1,0,0,1
1250,male,2004,Brazil,0,3,0,3
1251,male,2004,Mexico,0,2,3,5
1252,male,2004,Switzerland,0,2,1,3
1253,male,2004,Denmark,0,2,0,2
1254,male,2004,Belarus,0,1,8,9
1255,male,2004,Algeria,0,1,3,4
1256,male,2004,Morocco,0,1,3,4
1257,male,2004,South Africa,0,1,2,3
1258,male,2004,Kingdom of Saudi Arabia,0,1,1,2
1259,male,2004,Republic of Moldova,0,1,1,2
1260,male,2004,Slovakia,0,1,1,2
1261,male,2004,Trinidad and Tobago,0,1,1,2
1262,male,2004,Argentina,0,1,0,1
1263,male,2004,Belgium,0,1,0,1
1264,male,2004,Indonesia,0,1,0,1
1265,male,2004,Uruguay,0,1,0,1
1266,male,2004,Georgia,0,0,6,6
1267,male,2004,Democratic People's Republic of Korea,0,0,2,2
1268,male,2004,Armenia,0,0,1,1
1269,male,2004,Barbados,0,0,1,1
1270,male,2004,Chinese Taipei,0,0,1,1
1271,male,2004,Israel,0,0,1,1
1272,male,2004,Jamaica,0,0,1,1
1273,male,2004,Kuwait,0,0,1,1
1274,male,2004,Kyrgyzstan,0,0,1,1
1275,male,2004,North Macedonia,0,0,1,1
1276,male,2004,Portugal,0,0,1,1
1277,male,2004,Qatar,0,0,1,1
1278,male,2008,United States,18,20,9,47
1279,male,2008,Russian Federation,15,9,19,43
1280,male,2008,People's Republic of China,9,5,5,19
1281,male,2008,Italy,7,2,4,13
1282,male,2008,Japan,6,4,5,15
1283,male,2008,Cuba,6,3,5,14
1284,male,2008,Australia,5,4,6,15
1285,male,2008,Republic of Korea,4,6,5,15
1286,male,2008,France,4,2,4,10
1287,male,2008,Great Britain,4,2,4,10
1288,male,2008,Germany,3,2,9,14
1289,male,2008,Ukraine,3,2,2,7
1290,male,2008,Norway,3,0,0,3
1291,male,2008,Spain,2,6,3,11
1292,male,2008,Türkiye,2,3,4,9
1293,male,2008,Greece,2,2,2,6
1294,male,2008,Islamic Republic of Iran,2,2,2,6
1295,male,2008,Georgia,2,2,0,4
1296,male,2008,Uzbekistan,2,1,2,5
1297,male,2008,Canada,2,1,1,4
1298,male,2008,Sweden,2,1,0,3
1299,male,2008,Brazil,2,0,3,5
1300,male,2008,Morocco,2,0,0,2
1301,male,2008,Kazakhstan,1,4,3,8
1302,male,2008,Belarus,1,3,2,6
1303,male,2008,Hungary,1,3,2,6
1304,male,2008,Netherlands,1,2,3,6
1305,male,2008,Kenya,1,2,2,5
1306,male,2008,Ethiopia,1,2,0,3
1307,male,2008,New Zealand,1,2,0,3
1308,male,2008,Bulgaria,1,1,6,8
1309,male,2008,Egypt,1,1,3,5
1310,male,2008,Thailand,1,1,1,3
1311,male,2008,Chinese Taipei,1,1,0,2
1312,male,2008,Lithuania,1,1,0,2
1313,male,2008,Azerbaijan,1,0,2,3
1314,male,2008,Czechia,1,0,2,3
1315,male,2008,Chile,1,0,1,2
1316,male,2008,Indonesia,1,0,1,2
1317,male,2008,Israel,1,0,1,2
1318,male,2008,Poland,1,0,1,2
1319,male,2008,Switzerland,1,0,1,2
1320,male,2008,Dominican Republic,1,0,0,1
1321,male,2008,United Arab Emirates,1,0,0,1
1322,male,2008,Romania,0,3,3,6
1323,male,2008,Austria,0,3,1,4
1324,male,2008,Latvia,0,3,0,3
1325,male,2008,Portugal,0,2,1,3
1326,male,2008,Slovakia,0,2,1,3
1327,male,2008,South Africa,0,2,1,3
1328,male,2008,Finland,0,2,0,2
1329,male,2008,Estonia,0,1,2,3
1330,male,2008,Croatia,0,1,1,2
1331,male,2008,Democratic People's Republic of Korea,0,1,1,2
1332,male,2008,Denmark,0,1,1,2
1333,male,2008,India,0,1,0,1
1334,male,2008,Jamaica,0,1,0,1
1335,male,2008,Mexico,0,1,0,1
1336,male,2008,Belgium,0,0,1,1
1337,male,2008,Eritrea,0,0,1,1
1338,male,2008,Mongolia,0,0,1,1
1339,male,2008,Slovenia,0,0,1,1
1340,male,2008,Syrian Arab Republic,0,0,1,1
1341,male,2008,Trinidad and Tobago,0,0,1,1
1342,male,2008,Venezuela,0,0,1,1
1343,male,2012,People's Republic of China,19,9,8,36
1344,male,2012,United States,13,12,17,42
1345,male,2012,Russian Federation,13,3,14,30
1346,male,2012,Great Britain,7,6,6,19
1347,male,2012,Republic of Korea,6,6,2,14
1348,male,2012,Germany,6,3,3,12
1349,male,2012,Italy,4,4,3,11
1350,male,2012,Japan,4,4,2,10
1351,male,2012,Ukraine,4,2,6,12
1352,male,2012,Kenya,4,1,4,9
1353,male,2012,France,3,12,12,27
1354,male,2012,Australia,3,4,6,13
1355,male,2012,Spain,3,3,1,7
1356,male,2012,Georgia,3,2,1,6
1357,male,2012,Poland,3,1,1,5
1358,male,2012,Cuba,2,4,13,19
1359,male,2012,Norway,2,3,0,5
1360,male,2012,Ethiopia,2,1,1,4
1361,male,2012,Mongolia,2,1,0,3
1362,male,2012,Jamaica,2,0,0,2
1363,male,2012,Canada,1,4,3,8
1364,male,2012,Hungary,1,4,0,5
1365,male,2012,Belarus,1,3,2,6
1366,male,2012,Kazakhstan,1,2,3,6
1367,male,2012,New Zealand,1,2,2,5
1368,male,2012,Azerbaijan,1,1,3,5
1369,male,2012,Switzerland,1,1,2,4
1370,male,2012,Czechia,1,1,1,3
1371,male,2012,Latvia,1,1,1,3
1372,male,2012,Slovenia,1,1,1,3
1373,male,2012,Dominican Republic,1,1,0,2
1374,male,2012,Slovakia,1,1,0,2
1375,male,2012,Thailand,1,1,0,2
1376,male,2012,Brazil,1,0,3,4
1377,male,2012,Türkiye,1,0,3,4
1378,male,2012,India,1,0,2,3
1379,male,2012,Netherlands,1,0,2,3
1380,male,2012,Islamic Republic of Iran,1,0,1,2
1381,male,2012,Estonia,1,0,0,1
1382,male,2012,Mexico,1,0,0,1
1383,male,2012,Panama,1,0,0,1
1384,male,2012,Portugal,1,0,0,1
1385,male,2012,Tunisia,1,0,0,1
1386,male,2012,Lithuania,0,2,2,4
1387,male,2012,Sweden,0,2,0,2
1388,male,2012,Armenia,0,1,4,5
1389,male,2012,Ireland,0,1,2,3
1390,male,2012,Kyrgyzstan,0,1,2,3
1391,male,2012,Uzbekistan,0,1,2,3
1392,male,2012,Serbia,0,1,1,2
1393,male,2012,Tajikistan,0,1,1,2
1394,male,2012,Algeria,0,1,0,1
1395,male,2012,Austria,0,1,0,1
1396,male,2012,Chile,0,1,0,1
1397,male,2012,Colombia,0,1,0,1
1398,male,2012,Croatia,0,1,0,1
1399,male,2012,Ecuador,0,1,0,1
1400,male,2012,Greece,0,1,0,1
1401,male,2012,Malaysia,0,1,0,1
1402,male,2012,Morocco,0,1,0,1
1403,male,2012,South Africa,0,1,0,1
1404,male,2012,Sudan,0,1,0,1
1405,male,2012,Trinidad and Tobago,0,1,0,1
1406,male,2012,Vietnam,0,1,0,1
1407,male,2012,Bulgaria,0,0,3,3
1408,male,2012,Chinese Taipei,0,0,2,2
1409,male,2012,Finland,0,0,2,2
1410,male,2012,Indonesia,0,0,2,2
1411,male,2012,Romania,0,0,2,2
1412,male,2012,Afghanistan,0,0,1,1
1413,male,2012,Democratic People's Republic of Korea,0,0,1,1
1414,male,2012,Egypt,0,0,1,1
1415,male,2012,Israel,0,0,1,1
1416,male,2012,Mauritius,0,0,1,1
1417,male,2012,Nigeria,0,0,1,1
1418,male,2012,Republic of Moldova,0,0,1,1
1419,male,2012,The Bahamas,0,0,1,1
1420,male,2012,Togo,0,0,1,1
1421,male,2016,United States,14,10,11,35
1422,male,2016,Great Britain,13,5,8,26
1423,male,2016,People's Republic of China,12,9,9,30
1424,male,2016,Russian Federation,9,7,11,27
1425,male,2016,Republic of Korea,7,7,3,17
1426,male,2016,Islamic Republic of Iran,7,5,1,13
1427,male,2016,France,5,3,4,12
1428,male,2016,Hungary,4,2,4,10
1429,male,2016,Cuba,4,1,6,11
1430,male,2016,Germany,3,10,6,19
1431,male,2016,Italy,3,6,5,14
1432,male,2016,Japan,3,5,10,18
1433,male,2016,Ukraine,3,2,3,8
1434,male,2016,Australia,2,4,1,7
1435,male,2016,Jamaica,2,2,2,6
1436,male,2016,Czechia,2,2,1,5
1437,male,2016,Azerbaijan,2,1,4,7
1438,male,2016,Kazakhstan,2,1,4,7
1439,male,2016,Kenya,2,1,4,7
1440,male,2016,Poland,2,1,3,6
1441,male,2016,Netherlands,2,1,2,5
1442,male,2016,South Africa,2,1,0,3
1443,male,2016,Democratic People's Republic of Korea,2,0,2,4
1444,male,2016,Spain,1,4,1,6
1445,male,2016,Brazil,1,2,4,7
1446,male,2016,Georgia,1,2,3,6
1447,male,2016,Denmark,1,2,0,3
1448,male,2016,Switzerland,1,2,0,3
1449,male,2016,Norway,1,1,1,3
1450,male,2016,Dominican Republic,1,1,0,2
1451,male,2016,Argentina,1,0,1,2
1452,male,2016,New Zealand,1,0,1,2
1453,male,2016,Trinidad and Tobago,1,0,1,2
1454,male,2016,Tunisia,1,0,1,2
1455,male,2016,Türkiye,1,0,1,2
1456,male,2016,Algeria,1,0,0,1
1457,male,2016,Belarus,1,0,0,1
1458,male,2016,Croatia,1,0,0,1
1459,male,2016,Grenada,1,0,0,1
1460,male,2016,Latvia,1,0,0,1
1461,male,2016,Romania,1,0,0,1
1462,male,2016,Uganda,1,0,0,1
1463,male,2016,Venezuela,1,0,0,1
1464,male,2016,Canada,0,3,5,8
1465,male,2016,Colombia,0,2,2,4
1466,male,2016,India,0,2,2,4
1467,male,2016,Mongolia,0,2,2,4
1468,male,2016,Egypt,0,2,1,3
1469,male,2016,Ireland,0,1,4,5
1470,male,2016,Sweden,0,1,3,4
1471,male,2016,Armenia,0,1,1,2
1472,male,2016,Estonia,0,1,1,2
1473,male,2016,Ethiopia,0,1,1,2
1474,male,2016,Indonesia,0,1,1,2
1475,male,2016,Puerto Rico,0,1,1,2
1476,male,2016,Qatar,0,1,1,2
1477,male,2016,Slovenia,0,1,1,2
1478,male,2016,Belgium,0,1,0,1
1479,male,2016,Botswana,0,1,0,1
1480,male,2016,Cyprus,0,1,0,1
1481,male,2016,Finland,0,1,0,1
1482,male,2016,Gabon,0,1,0,1
1483,male,2016,Guatemala,0,1,0,1
1484,male,2016,Malaysia,0,1,0,1
1485,male,2016,Thailand,0,1,0,1
1486,male,2016,Uzbekistan,0,0,3,3
1487,male,2016,Lithuania,0,0,2,2
1488,male,2016,Afghanistan,0,0,1,1
1489,male,2016,Bulgaria,0,0,1,1
1490,male,2016,Greece,0,0,1,1
1491,male,2016,Kuwait,0,0,1,1
1492,male,2016,Morocco,0,0,1,1
1493,male,2016,Serbia,0,0,1,1
1494,male,2016,Slovakia,0,0,1,1
1495,male,2016,Vietnam,0,0,1,1
1496,male,2020,Great Britain,14,8,7,29
1497,male,2020,United States,13,15,17,45
1498,male,2020,People's Republic of China,9,7,7,23
1499,male,2020,Russian Federation,8,4,13,25
1500,male,2020,Italy,7,2,3,12
1501,male,2020,Germany,7,0,5,12
1502,male,2020,Cuba,5,1,3,9
1503,male,2020,Japan,4,5,10,19
1504,male,2020,Uzbekistan,4,2,7,13
1505,male,2020,France,3,8,10,21
1506,male,2020,Kenya,3,3,0,6
1507,male,2020,Republic of Korea,3,2,6,11
1508,male,2020,Australia,3,2,1,6
1509,male,2020,Islamic Republic of Iran,3,1,3,7
1510,male,2020,Jamaica,3,0,0,3
1511,male,2020,Brazil,2,4,4,10
1512,male,2020,Ukraine,2,4,1,7
1513,male,2020,Kazakhstan,2,3,4,9
1514,male,2020,Netherlands,2,3,0,5
1515,male,2020,Georgia,2,1,4,7
1516,male,2020,Switzerland,2,0,0,2
1517,male,2020,Azerbaijan,1,6,7,14
1518,male,2020,South Africa,1,4,1,6
1519,male,2020,Türkiye,1,3,3,7
1520,male,2020,Armenia,1,3,0,4
1521,male,2020,Belarus,1,2,2,5
1522,male,2020,Czechia,1,2,2,5
1523,male,2020,Croatia,1,2,1,4
1524,male,2020,Hungary,1,2,1,4
1525,male,2020,Canada,1,1,3,5
1526,male,2020,Spain,1,1,3,5
1527,male,2020,Colombia,1,1,2,4
1528,male,2020,Belgium,1,1,1,3
1529,male,2020,Democratic People's Republic of Korea,1,1,1,3
1530,male,2020,Greece,1,1,0,2
1531,male,2020,Slovakia,1,1,0,2
1532,male,2020,Vietnam,1,1,0,2
1533,male,2020,New Zealand,1,0,3,4
1534,male,2020,Independent Olympic Athletes,1,0,1,2
1535,male,2020,Côte d'Ivoire,1,0,0,1
1536,male,2020,Jordan,1,0,0,1
1537,male,2020,Serbia,1,0,0,1
1538,male,2020,Singapore,1,0,0,1
1539,male,2020,Tajikistan,1,0,0,1
1540,male,2020,Sweden,0,3,0,3
1541,male,2020,Denmark,0,2,2,4
1542,male,2020,Algeria,0,2,0,2
1543,male,2020,Slovenia,0,2,0,2
1544,male,2020,Ethiopia,0,1,2,3
1545,male,2020,Mexico,0,1,2,3
1546,male,2020,Poland,0,1,2,3
1547,male,2020,Malaysia,0,1,1,2
1548,male,2020,Thailand,0,1,1,2
1549,male,2020,Argentina,0,1,0,1
1550,male,2020,Grenada,0,1,0,1
1551,male,2020,Indonesia,0,1,0,1
1552,male,2020,Niger,0,1,0,1
1553,male,2020,Qatar,0,1,0,1
1554,male,2020,Venezuela,0,1,0,1
1555,male,2020,Dominican Republic,0,0,1,1
1556,male,2020,Egypt,0,0,1,1
1557,male,2020,Israel,0,0,1,1
1558,male,2020,Lithuania,0,0,1,1
1559,male,2020,Mongolia,0,0,1,1
1560,male,2020,Morocco,0,0,1,1
1561,male,2020,Norway,0,0,1,1
1562,male,2020,Romania,0,0,1,1
1563,male,2020,Trinidad and Tobago,0,0,1,1
1564,male,2020,Tunisia,0,0,1,1
1565,male,2020,United Arab Emirates,0,0,1,1
1566,female,1896,United States,12,13,9,34
1567,female,1896,People's Republic of China,11,10,7,28
1568,female,1896,Great Britain,10,8,9,27
1569,female,1896,Japan,10,4,6,20
1570,female,1896,ROC,9,5,13,27
1571,female,1896,Cuba,6,2,4,12
1572,female,1896,Hungary,5,6,2,13
1573,female,1896,Italy,5,5,7,17
1574,female,1896,Australia,4,2,6,12
1575,female,1896,Netherlands,3,5,2,10
1576,female,1896,Czechia,3,3,2,8
1577,female,1896,France,3,3,2,8
1578,female,1896,Brazil,3,2,6,11
1579,female,1896,Islamic Republic of Iran,3,2,2,7
1580,female,1896,Norway,3,2,1,6
1581,female,1896,Uzbekistan,3,0,2,5
1582,female,1896,Georgia,2,5,1,8
1583,female,1896,Germany,2,3,6,11
1584,female,1896,Kenya,2,2,1,5
1585,female,1896,Sweden,2,2,0,4
1586,female,1896,Canada,2,1,2,5
1587,female,1896,Poland,2,0,3,5
1588,female,1896,Greece,2,0,1,3
1589,female,1896,Slovenia,2,0,1,3
1590,female,1896,Qatar,2,0,0,2
1591,female,1896,Ukraine,1,3,3,7
1592,female,1896,Spain,1,2,3,6
1593,female,1896,Republic of Korea,1,1,6,8
1594,female,1896,Türkiye,1,1,6,8
1595,female,1896,Belarus,1,1,1,3
1596,female,1896,India,1,1,1,3
1597,female,1896,Uganda,1,1,1,3
1598,female,1896,Denmark,1,1,0,2
1599,female,1896,Ethiopia,1,1,0,2
1600,female,1896,Tunisia,1,1,0,2
1601,female,1896,Portugal,1,0,2,3
1602,female,1896,Jamaica,1,0,1,2
1603,female,1896,Ecuador,1,0,0,1
1604,female,1896,"Hong Kong, China",1,0,0,1
1605,female,1896,Israel,1,0,0,1
1606,female,1896,Morocco,1,0,0,1
1607,female,1896,The Bahamas,1,0,0,1
1608,female,1896,Venezuela,0,3,0,3
1609,female,1896,Armenia,0,2,2,4
1610,female,1896,Azerbaijan,0,2,2,4
1611,female,1896,Croatia,0,2,2,4
1612,female,1896,Chinese Taipei,0,2,1,3
1613,female,1896,Colombia,0,2,1,3
1614,female,1896,Slovakia,0,2,0,2
1615,female,1896,New Zealand,0,1,4,5
1616,female,1896,Belgium,0,1,2,3
1617,female,1896,Egypt,0,1,2,3
1618,female,1896,Indonesia,0,1,2,3
1619,female,1896,Serbia,0,1,2,3
1620,female,1896,Switzerland,0,1,2,3
1621,female,1896,Jordan,0,1,1,2
1622,female,1896,Mongolia,0,1,1,2
1623,female,1896,Philippines,0,1,1,2
1624,female,1896,Dominican Republic,0,1,0,1
1625,female,1896,Kingdom of Saudi Arabia,0,1,0,1
1626,female,1896,Kyrgyzstan,0,1,0,1
1627,female,1896,Malaysia,0,1,0,1
1628,female,1896,North Macedonia,0,1,0,1
1629,female,1896,Kazakhstan,0,0,6,6
1630,female,1896,Austria,0,0,3,3
1631,female,1896,Burkina Faso,0,0,1,1
1632,female,1896,Finland,0,0,1,1
1633,female,1896,Ghana,0,0,1,1
1634,female,1896,Grenada,0,0,1,1
1635,female,1896,Ireland,0,0,1,1
1636,female,1896,Kuwait,0,0,1,1
1637,female,1896,Latvia,0,0,1,1
1638,female,1896,Republic of Moldova,0,0,1,1
1639,female,1896,San Marino,0,0,1,1
1640,female,1896,Syrian Arab Republic,0,0,1,1
1641,female,1900,United States,17,16,18,51
1642,female,1900,People's Republic of China,15,13,7,35
1643,female,1900,Japan,13,6,8,27
1644,female,1900,Australia,7,2,7,16
1645,female,1900,Germany,5,2,3,10
1646,female,1900,ROC,4,10,6,20
1647,female,1900,Great Britain,4,6,8,18
1648,female,1900,Netherlands,4,3,9,16
1649,female,1900,Canada,3,3,4,10
1650,female,1900,Switzerland,3,2,3,8
1651,female,1900,New Zealand,3,1,2,6
1652,female,1900,Brazil,2,3,1,6
1653,female,1900,Kenya,2,2,1,5
1654,female,1900,Bulgaria,2,1,2,5
1655,female,1900,Jamaica,2,1,2,5
1656,female,1900,Serbia,2,0,1,3
1657,female,1900,Belgium,2,0,0,2
1658,female,1900,Kosovo,2,0,0,2
1659,female,1900,France,1,4,3,8
1660,female,1900,Italy,1,3,7,11
1661,female,1900,Spain,1,3,1,5
1662,female,1900,Republic of Korea,1,2,1,4
1663,female,1900,South Africa,1,2,0,3
1664,female,1900,Chinese Taipei,1,1,4,6
1665,female,1900,Türkiye,1,1,3,5
1666,female,1900,Austria,1,1,2,4
1667,female,1900,Poland,1,1,1,3
1668,female,1900,Ecuador,1,1,0,2
1669,female,1900,Philippines,1,1,0,2
1670,female,1900,Slovenia,1,1,0,2
1671,female,1900,Denmark,1,0,3,4
1672,female,1900,Egypt,1,0,2,3
1673,female,1900,Israel,1,0,1,2
1674,female,1900,Thailand,1,0,1,2
1675,female,1900,Bermuda,1,0,0,1
1676,female,1900,Croatia,1,0,0,1
1677,female,1900,Ireland,1,0,0,1
1678,female,1900,Puerto Rico,1,0,0,1
1679,female,1900,Slovakia,1,0,0,1
1680,female,1900,The Bahamas,1,0,0,1
1681,female,1900,Uganda,1,0,0,1
1682,female,1900,Venezuela,1,0,0,1
1683,female,1900,Ukraine,0,2,6,8
1684,female,1900,"Hong Kong, China",0,2,2,4
1685,female,1900,Colombia,0,2,0,2
1686,female,1900,Sweden,0,2,0,2
1687,female,1900,Azerbaijan,0,1,2,3
1688,female,1900,Belarus,0,1,2,3
1689,female,1900,India,0,1,2,3
1690,female,1900,Cuba,0,1,1,2
1691,female,1900,Dominican Republic,0,1,1,2
1692,female,1900,Hungary,0,1,1,2
1693,female,1900,Kyrgyzstan,0,1,1,2
1694,female,1900,Nigeria,0,1,1,2
1695,female,1900,Bahrain,0,1,0,1
1696,female,1900,Czechia,0,1,0,1
1697,female,1900,Lithuania,0,1,0,1
1698,female,1900,Namibia,0,1,0,1
1699,female,1900,Portugal,0,1,0,1
1700,female,1900,Romania,0,1,0,1
1701,female,1900,Turkmenistan,0,1,0,1
1702,female,1900,Ethiopia,0,0,2,2
1703,female,1900,Kazakhstan,0,0,2,2
1704,female,1900,Mongolia,0,0,2,2
1705,female,1900,Côte d'Ivoire,0,0,1,1
1706,female,1900,Estonia,0,0,1,1
1707,female,1900,Finland,0,0,1,1
1708,female,1900,Indonesia,0,0,1,1
1709,female,1900,Mexico,0,0,1,1
1710,female,1900,San Marino,0,0,1,1
1711,female,1904,United States,1,0,1,2
1712,female,1904,Great Britain,1,0,0,1
1713,female,1904,France,0,1,1,2
1714,female,1904,Switzerland,0,1,0,1
1715,female,1904,Bohemia,0,0,1,1
1716,female,1908,United States,1,0,1,2
1717,female,1908,Great Britain,1,0,0,1
1718,female,1908,France,0,1,1,2
1719,female,1908,Switzerland,0,1,0,1
1720,female,1908,Bohemia,0,0,1,1
1721,female,1912,Great Britain,4,3,3,10
1722,female,1912,Germany,0,1,0,1
1723,female,1912,Sweden,0,0,1,1
1724,female,1920,Great Britain,4,3,3,10
1725,female,1920,Germany,0,1,0,1
1726,female,1920,Sweden,0,0,1,1
1727,female,1924,Australasia,1,1,0,2
1728,female,1924,Sweden,1,1,0,2
1729,female,1924,Great Britain,1,0,3,4
1730,female,1924,France,1,0,0,1
1731,female,1924,Denmark,0,1,0,1
1732,female,1924,Germany,0,1,0,1
1733,female,1924,Norway,0,0,1,1
1734,female,1928,United States,3,3,4,10
1735,female,1928,Sweden,1,1,1,3
1736,female,1928,France,1,1,0,2
1737,female,1928,Denmark,1,0,0,1
1738,female,1928,Great Britain,0,2,1,3
1739,female,1932,United States,6,5,4,15
1740,female,1932,Great Britain,1,3,2,6
1741,female,1932,Denmark,1,0,1,2
1742,female,1932,France,0,1,0,1
1743,female,1932,Sweden,0,0,1,1
1744,female,1936,United States,5,4,3,12
1745,female,1936,Germany,3,0,3,6
1746,female,1936,Netherlands,1,3,0,4
1747,female,1936,Canada,1,1,1,3
1748,female,1936,Poland,1,0,0,1
1749,female,1936,Great Britain,0,3,2,5
1750,female,1936,Japan,0,1,0,1
1751,female,1936,Sweden,0,0,3,3
1752,female,1948,United States,9,7,4,20
1753,female,1948,Poland,1,1,1,3
1754,female,1948,Australia,1,1,0,2
1755,female,1948,Austria,1,0,0,1
1756,female,1948,Canada,0,1,1,2
1757,female,1948,Germany,0,1,1,2
1758,female,1948,Great Britain,0,1,1,2
1759,female,1948,Japan,0,1,0,1
1760,female,1948,Netherlands,0,1,0,1
1761,female,1948,South Africa,0,0,2,2
1762,female,1948,Denmark,0,0,1,1
1763,female,1948,Hungary,0,0,1,1
1764,female,1952,United States,4,4,2,10
1765,female,1952,Netherlands,4,1,1,6
1766,female,1952,Denmark,3,2,2,7
1767,female,1952,France,2,0,2,4
1768,female,1952,Hungary,2,0,2,4
1769,female,1952,Finland,1,1,0,2
1770,female,1952,Austria,1,0,3,4
1771,female,1952,Great Britain,0,4,2,6
1772,female,1952,Italy,0,2,0,2
1773,female,1952,Australia,0,1,3,4
1774,female,1952,Argentina,0,1,0,1
1775,female,1952,Ireland,0,0,1,1
1776,female,1952,Sweden,0,0,1,1
1777,female,1956,Soviet Union,5,9,7,21
1778,female,1956,Hungary,5,3,5,13
1779,female,1956,Australia,3,0,1,4
1780,female,1956,United States,2,1,3,6
1781,female,1956,South Africa,2,1,0,3
1782,female,1956,New Zealand,1,0,1,2
1783,female,1956,Czechoslovakia,1,0,0,1
1784,female,1956,Finland,1,0,0,1
1785,female,1956,Italy,1,0,0,1
1786,female,1956,Netherlands,0,3,0,3
1787,female,1956,Great Britain,0,1,2,3
1788,female,1956,Denmark,0,1,1,2
1789,female,1956,Germany,0,1,1,2
1790,female,1956,Austria,0,1,0,1
1791,female,1956,France,0,1,0,1
1792,female,1960,Soviet Union,6,6,5,17
1793,female,1960,Australia,5,2,4,11
1794,female,1960,United States,4,5,3,12
1795,female,1960,Hungary,3,2,1,6
1796,female,1960,Great Britain,2,1,1,4
1797,female,1960,Germany,1,4,2,7
1798,female,1960,Czechoslovakia,1,1,0,2
1799,female,1960,Poland,1,0,0,1
1800,female,1960,Romania,0,1,1,2
1801,female,1960,Chile,0,1,0,1
1802,female,1960,Canada,0,0,1,1
1803,female,1960,Denmark,0,0,1,1
1804,female,1960,France,0,0,1,1
1805,female,1960,Sweden,0,0,1,1
1806,female,1964,Soviet Union,6,6,5,17
1807,female,1964,Australia,5,2,4,11
1808,female,1964,United States,4,5,3,12
1809,female,1964,Hungary,3,2,1,6
1810,female,1964,Great Britain,2,1,1,4
1811,female,1964,Germany,1,4,2,7
1812,female,1964,Czechoslovakia,1,1,0,2
1813,female,1964,Poland,1,0,0,1
1814,female,1964,Romania,0,1,1,2
1815,female,1964,Chile,0,1,0,1
1816,female,1964,Canada,0,0,1,1
1817,female,1964,Denmark,0,0,1,1
1818,female,1964,France,0,0,1,1
1819,female,1964,Sweden,0,0,1,1
1820,female,1968,United States,7,6,7,20
1821,female,1968,Soviet Union,7,4,10,21
1822,female,1968,Czechoslovakia,3,0,0,3
1823,female,1968,Germany,2,5,0,7
1824,female,1968,Great Britain,2,2,0,4
1825,female,1968,Australia,2,1,3,6
1826,female,1968,Romania,2,1,1,4
1827,female,1968,Hungary,1,2,1,4
1828,female,1968,Poland,0,3,1,4
1829,female,1968,France,0,2,0,2
1830,female,1968,Netherlands,0,1,0,1
1831,female,1968,Italy,0,0,1,1
1832,female,1968,New Zealand,0,0,1,1
1833,female,1972,United States,12,8,10,30
1834,female,1972,Czechoslovakia,6,1,0,7
1835,female,1972,Soviet Union,4,5,10,19
1836,female,1972,Australia,2,2,2,6
1837,female,1972,Romania,2,2,1,5
1838,female,1972,East Germany,1,4,1,6
1839,female,1972,West Germany,1,2,0,3
1840,female,1972,Yugoslavia,1,1,0,2
1841,female,1972,Hungary,1,0,3,4
1842,female,1972,Netherlands,1,0,1,2
1843,female,1972,Poland,1,0,1,2
1844,female,1972,France,1,0,0,1
1845,female,1972,Great Britain,0,3,0,3
1846,female,1972,Canada,0,2,0,2
1847,female,1972,Austria,0,1,1,2
1848,female,1972,Mexico,0,1,1,2
1849,female,1972,Chinese Taipei,0,0,1,1
1850,female,1976,East Germany,8,8,7,23
1851,female,1976,United States,8,5,6,19
1852,female,1976,Soviet Union,7,6,6,19
1853,female,1976,Australia,5,3,2,10
1854,female,1976,West Germany,4,3,1,8
1855,female,1976,Italy,1,1,3,5
1856,female,1976,Great Britain,1,1,0,2
1857,female,1976,Sweden,1,1,0,2
1858,female,1976,Japan,1,0,0,1
1859,female,1976,Bulgaria,0,2,2,4
1860,female,1976,Hungary,0,2,2,4
1861,female,1976,Romania,0,2,0,2
1862,female,1976,Canada,0,1,1,2
1863,female,1976,Czechoslovakia,0,1,1,2
1864,female,1976,Poland,0,1,1,2
1865,female,1976,Netherlands,0,1,0,1
1866,female,1976,Austria,0,0,1,1
1867,female,1976,Cuba,0,0,1,1
1868,female,1980,East Germany,19,11,7,37
1869,female,1980,Soviet Union,6,10,8,24
1870,female,1980,Romania,3,1,2,6
1871,female,1980,United States,2,6,5,13
1872,female,1980,Bulgaria,1,2,1,4
1873,female,1980,West Germany,1,2,1,4
1874,female,1980,Hungary,1,0,2,3
1875,female,1980,Poland,1,0,0,1
1876,female,1980,Switzerland,1,0,0,1
1877,female,1980,Italy,0,2,0,2
1878,female,1980,Canada,0,1,4,5
1879,female,1980,Sweden,0,1,0,1
1880,female,1980,Netherlands,0,0,2,2
1881,female,1980,Czechoslovakia,0,0,1,1
1882,female,1984,East Germany,16,15,16,47
1883,female,1984,Soviet Union,12,11,11,34
1884,female,1984,Romania,3,2,2,7
1885,female,1984,Australia,1,0,1,2
1886,female,1984,Austria,1,0,0,1
1887,female,1984,Cuba,1,0,0,1
1888,female,1984,France,1,0,0,1
1889,female,1984,Italy,1,0,0,1
1890,female,1984,Bulgaria,0,2,0,2
1891,female,1984,Poland,0,1,3,4
1892,female,1984,Czechoslovakia,0,1,0,1
1893,female,1984,Great Britain,0,1,0,1
1894,female,1984,Hungary,0,1,0,1
1895,female,1984,Denmark,0,0,1,1
1896,female,1984,Finland,0,0,1,1
1897,female,1984,Jamaica,0,0,1,1
1898,female,1988,United States,20,22,8,50
1899,female,1988,Romania,8,5,7,20
1900,female,1988,Canada,4,2,1,7
1901,female,1988,People's Republic of China,4,1,1,6
1902,female,1988,Netherlands,3,0,4,7
1903,female,1988,West Germany,2,3,6,11
1904,female,1988,Great Britain,1,3,6,10
1905,female,1988,Australia,1,2,3,6
1906,female,1988,Italy,1,2,1,4
1907,female,1988,Republic of Korea,1,0,1,2
1908,female,1988,Morocco,1,0,0,1
1909,female,1988,Sweden,1,0,0,1
1910,female,1988,Denmark,0,1,0,1
1911,female,1988,Finland,0,1,0,1
1912,female,1988,Norway,0,1,0,1
1913,female,1988,Belgium,0,0,2,2
1914,female,1988,France,0,0,2,2
1915,female,1988,Jamaica,0,0,2,2
1916,female,1988,Japan,0,0,1,1
1917,female,1988,Portugal,0,0,1,1
1918,female,1988,Switzerland,0,0,1,1
1919,female,1992,East Germany,12,15,13,40
1920,female,1992,Soviet Union,10,6,12,28
1921,female,1992,United States,8,4,8,20
1922,female,1992,Romania,4,4,3,11
1923,female,1992,West Germany,4,3,2,9
1924,female,1992,People's Republic of China,3,5,3,11
1925,female,1992,Bulgaria,3,4,5,12
1926,female,1992,Australia,1,1,1,3
1927,female,1992,Republic of Korea,1,1,1,3
1928,female,1992,Hungary,1,1,0,2
1929,female,1992,Yugoslavia,1,0,1,2
1930,female,1992,Canada,1,0,0,1
1931,female,1992,Netherlands,1,0,0,1
1932,female,1992,Portugal,1,0,0,1
1933,female,1992,Great Britain,0,2,2,4
1934,female,1992,France,0,1,1,2
1935,female,1992,Japan,0,1,1,2
1936,female,1992,Argentina,0,1,0,1
1937,female,1992,Costa Rica,0,1,0,1
1938,female,1992,Jamaica,0,1,0,1
1939,female,1992,Poland,0,0,1,1
1940,female,1992,Switzerland,0,0,1,1
1941,female,1996,People's Republic of China,11,10,6,27
1942,female,1996,Unified Team,9,11,7,27
1943,female,1996,United States,9,9,14,32
1944,female,1996,Germany,8,5,8,21
1945,female,1996,Hungary,4,3,0,7
1946,female,1996,Republic of Korea,3,2,1,6
1947,female,1996,France,3,1,3,7
1948,female,1996,Romania,3,1,2,6
1949,female,1996,Spain,2,2,1,5
1950,female,1996,Cuba,2,1,4,7
1951,female,1996,Japan,1,4,3,8
1952,female,1996,Australia,1,3,5,9
1953,female,1996,Great Britain,1,1,2,4
1954,female,1996,Italy,1,1,0,2
1955,female,1996,Netherlands,1,0,4,5
1956,female,1996,Canada,1,0,2,3
1957,female,1996,New Zealand,1,0,1,2
1958,female,1996,Algeria,1,0,0,1
1959,female,1996,Estonia,1,0,0,1
1960,female,1996,Ethiopia,1,0,0,1
1961,female,1996,Greece,1,0,0,1
1962,female,1996,Indonesia,1,0,0,1
1963,female,1996,Norway,1,0,0,1
1964,female,1996,Bulgaria,0,3,2,5
1965,female,1996,Jamaica,0,2,1,3
1966,female,1996,Belgium,0,1,1,2
1967,female,1996,Independent Olympic Athletes,0,1,1,2
1968,female,1996,Israel,0,1,0,1
1969,female,1996,South Africa,0,1,0,1
1970,female,1996,Poland,0,0,2,2
1971,female,1996,Colombia,0,0,1,1
1972,female,1996,Democratic People's Republic of Korea,0,0,1,1
1973,female,1996,Mongolia,0,0,1,1
1974,female,1996,Türkiye,0,0,1,1
1975,female,2000,United States,8,8,10,26
1976,female,2000,People's Republic of China,7,7,4,18
1977,female,2000,France,7,3,4,14
1978,female,2000,Russian Federation,6,7,2,15
1979,female,2000,Ukraine,4,1,3,8
1980,female,2000,Germany,3,7,5,15
1981,female,2000,Republic of Korea,3,2,1,6
1982,female,2000,Ireland,3,0,1,4
1983,female,2000,Italy,2,4,5,11
1984,female,2000,Romania,2,3,4,9
1985,female,2000,Hungary,2,0,3,5
1986,female,2000,South Africa,2,0,1,3
1987,female,2000,Australia,1,4,3,8
1988,female,2000,Cuba,1,2,3,6
1989,female,2000,Japan,1,2,2,5
1990,female,2000,Jamaica,1,2,0,3
1991,female,2000,Belarus,1,1,1,3
1992,female,2000,Belgium,1,1,1,3
1993,female,2000,Bulgaria,1,1,1,3
1994,female,2000,Poland,1,1,1,3
1995,female,2000,Czechia,1,0,2,3
1996,female,2000,Nigeria,1,0,2,3
1997,female,2000,Denmark,1,0,1,2
1998,female,2000,Ethiopia,1,0,1,2
1999,female,2000,Serbia and Montenegro,1,0,1,2
2000,female,2000,Costa Rica,1,0,0,1
2001,female,2000,Democratic People's Republic of Korea,1,0,0,1
2002,female,2000,Finland,1,0,0,1
2003,female,2000,"Hong Kong, China",1,0,0,1
2004,female,2000,Portugal,1,0,0,1
2005,female,2000,Sweden,1,0,0,1
2006,female,2000,Syrian Arab Republic,1,0,0,1
2007,female,2000,Canada,0,4,3,7
2008,female,2000,Netherlands,0,3,5,8
2009,female,2000,New Zealand,0,2,0,2
2010,female,2000,Spain,0,1,2,3
2011,female,2000,Indonesia,0,1,1,2
2012,female,2000,Chinese Taipei,0,1,0,1
2013,female,2000,Greece,0,1,0,1
2014,female,2000,Kenya,0,1,0,1
2015,female,2000,Slovenia,0,1,0,1
2016,female,2000,Austria,0,0,1,1
2017,female,2000,Great Britain,0,0,1,1
2018,female,2000,Mozambique,0,0,1,1
2019,female,2000,Norway,0,0,1,1
2020,female,2004,People's Republic of China,13,6,7,26
2021,female,2004,United States,9,4,11,24
2022,female,2004,Russian Federation,7,13,6,26
2023,female,2004,Netherlands,7,2,0,9
2024,female,2004,Italy,5,2,3,10
2025,female,2004,Romania,4,5,5,14
2026,female,2004,Australia,3,5,4,12
2027,female,2004,France,3,5,3,11
2028,female,2004,Republic of Korea,3,2,4,9
2029,female,2004,Great Britain,3,1,4,8
2030,female,2004,Belarus,3,1,3,7
2031,female,2004,Japan,2,3,4,9
2032,female,2004,Cuba,2,3,1,6
2033,female,2004,Ukraine,2,2,2,6
2034,female,2004,Hungary,2,1,1,4
2035,female,2004,Bulgaria,2,1,0,3
2036,female,2004,Poland,2,1,0,3
2037,female,2004,Germany,1,4,6,11
2038,female,2004,Sweden,1,2,1,4
2039,female,2004,Switzerland,1,2,1,4
2040,female,2004,Norway,1,2,0,3
2041,female,2004,Ethiopia,1,1,1,3
2042,female,2004,Spain,1,0,3,4
2043,female,2004,Lithuania,1,0,1,2
2044,female,2004,Algeria,1,0,0,1
2045,female,2004,Azerbaijan,1,0,0,1
2046,female,2004,Colombia,1,0,0,1
2047,female,2004,Czechia,1,0,0,1
2048,female,2004,Kazakhstan,1,0,0,1
2049,female,2004,Mexico,1,0,0,1
2050,female,2004,Mozambique,1,0,0,1
2051,female,2004,The Bahamas,1,0,0,1
2052,female,2004,Jamaica,0,3,2,5
2053,female,2004,Greece,0,3,1,4
2054,female,2004,Nigeria,0,2,0,2
2055,female,2004,Slovakia,0,2,0,2
2056,female,2004,Canada,0,1,3,4
2057,female,2004,Chinese Taipei,0,1,3,4
2058,female,2004,Indonesia,0,1,2,3
2059,female,2004,Democratic People's Republic of Korea,0,1,1,2
2060,female,2004,South Africa,0,1,1,2
2061,female,2004,Austria,0,1,0,1
2062,female,2004,Denmark,0,1,0,1
2063,female,2004,Ireland,0,1,0,1
2064,female,2004,Serbia and Montenegro,0,1,0,1
2065,female,2004,Sri Lanka,0,1,0,1
2066,female,2004,Vietnam,0,1,0,1
2067,female,2004,Belgium,0,0,2,2
2068,female,2004,Costa Rica,0,0,2,2
2069,female,2004,Argentina,0,0,1,1
2070,female,2004,Iceland,0,0,1,1
2071,female,2004,India,0,0,1,1
2072,female,2004,Kenya,0,0,1,1
2073,female,2004,Morocco,0,0,1,1
2074,female,2004,New Zealand,0,0,1,1
2075,female,2004,Portugal,0,0,1,1
2076,female,2004,Thailand,0,0,1,1
2077,female,2004,Türkiye,0,0,1,1
2078,female,2008,People's Republic of China,13,8,8,29
2079,female,2008,Japan,9,2,3,14
2080,female,2008,Russian Federation,8,11,9,28
2081,female,2008,United States,6,12,9,27
2082,female,2008,Australia,6,5,6,17
2083,female,2008,Ukraine,5,1,3,9
2084,female,2008,Romania,4,2,2,8
2085,female,2008,Hungary,4,1,0,5
2086,female,2008,France,3,6,5,14
2087,female,2008,Germany,3,4,5,12
2088,female,2008,Netherlands,3,3,3,9
2089,female,2008,Cuba,2,3,5,10
2090,female,2008,Republic of Korea,2,3,3,8
2091,female,2008,Greece,2,3,1,6
2092,female,2008,Great Britain,2,0,5,7
2093,female,2008,Thailand,2,0,3,5
2094,female,2008,Norway,2,0,0,2
2095,female,2008,Italy,1,4,2,7
2096,female,2008,Canada,1,3,1,5
2097,female,2008,Poland,1,2,3,6
2098,female,2008,Belarus,1,2,2,5
2099,female,2008,Ethiopia,1,1,2,4
2100,female,2008,Zimbabwe,1,1,1,3
2101,female,2008,Austria,1,1,0,2
2102,female,2008,Bulgaria,1,0,2,3
2103,female,2008,Belgium,1,0,1,2
2104,female,2008,Jamaica,1,0,1,2
2105,female,2008,The Bahamas,1,0,1,2
2106,female,2008,Cameroon,1,0,0,1
2107,female,2008,Chinese Taipei,1,0,0,1
2108,female,2008,New Zealand,1,0,0,1
2109,female,2008,Slovakia,1,0,0,1
2110,female,2008,Sweden,1,0,0,1
2111,female,2008,Türkiye,1,0,0,1
2112,female,2008,Democratic People's Republic of Korea,0,3,0,3
2113,female,2008,Czechia,0,2,2,4
2114,female,2008,Mexico,0,2,1,3
2115,female,2008,Kenya,0,2,0,2
2116,female,2008,Spain,0,1,2,3
2117,female,2008,Indonesia,0,1,0,1
2118,female,2008,Latvia,0,1,0,1
2119,female,2008,Lithuania,0,1,0,1
2120,female,2008,Morocco,0,1,0,1
2121,female,2008,Serbia and Montenegro,0,1,0,1
2122,female,2008,South Africa,0,1,0,1
2123,female,2008,Azerbaijan,0,0,2,2
2124,female,2008,Colombia,0,0,2,2
2125,female,2008,Slovenia,0,0,2,2
2126,female,2008,Argentina,0,0,1,1
2127,female,2008,Denmark,0,0,1,1
2128,female,2008,Switzerland,0,0,1,1
2129,female,2008,Venezuela,0,0,1,1
2130,female,2012,People's Republic of China,18,5,14,37
2131,female,2012,United States,9,18,14,41
2132,female,2012,Russian Federation,7,5,4,16
2133,female,2012,Great Britain,6,4,8,18
2134,female,2012,Australia,5,5,4,14
2135,female,2012,Germany,5,3,4,12
2136,female,2012,Italy,4,3,3,10
2137,female,2012,Japan,4,2,4,10
2138,female,2012,Republic of Korea,3,4,2,9
2139,female,2012,Jamaica,3,3,2,8
2140,female,2012,Romania,3,1,0,4
2141,female,2012,Kenya,2,3,2,7
2142,female,2012,Ukraine,2,2,4,8
2143,female,2012,Democratic People's Republic of Korea,2,2,1,5
2144,female,2012,Netherlands,2,1,2,5
2145,female,2012,Czechia,2,1,0,3
2146,female,2012,Ethiopia,2,1,0,3
2147,female,2012,Cuba,1,5,4,10
2148,female,2012,Canada,1,3,3,7
2149,female,2012,Zimbabwe,1,3,0,4
2150,female,2012,France,1,2,3,6
2151,female,2012,Thailand,1,1,2,4
2152,female,2012,Kazakhstan,1,1,1,3
2153,female,2012,Bulgaria,1,1,0,2
2154,female,2012,Chinese Taipei,1,1,0,2
2155,female,2012,Slovakia,1,1,0,2
2156,female,2012,Brazil,1,0,2,3
2157,female,2012,Mexico,1,0,1,2
2158,female,2012,Belgium,1,0,0,1
2159,female,2012,Cameroon,1,0,0,1
2160,female,2012,Finland,1,0,0,1
2161,female,2012,New Zealand,1,0,0,1
2162,female,2012,Norway,0,2,1,3
2163,female,2012,Croatia,0,1,3,4
2164,female,2012,Belarus,0,1,2,3
2165,female,2012,Colombia,0,1,1,2
2166,female,2012,Nigeria,0,1,1,2
2167,female,2012,Poland,0,1,1,2
2168,female,2012,Slovenia,0,1,1,2
2169,female,2012,Spain,0,1,1,2
2170,female,2012,Lithuania,0,1,0,1
2171,female,2012,Mongolia,0,1,0,1
2172,female,2012,Portugal,0,1,0,1
2173,female,2012,Samoa,0,1,0,1
2174,female,2012,Sweden,0,1,0,1
2175,female,2012,Türkiye,0,1,0,1
2176,female,2012,Austria,0,0,2,2
2177,female,2012,Indonesia,0,0,2,2
2178,female,2012,Algeria,0,0,1,1
2179,female,2012,Argentina,0,0,1,1
2180,female,2012,Azerbaijan,0,0,1,1
2181,female,2012,Denmark,0,0,1,1
2182,female,2012,Egypt,0,0,1,1
2183,female,2012,Georgia,0,0,1,1
2184,female,2012,Hungary,0,0,1,1
2185,female,2012,Morocco,0,0,1,1
2186,female,2012,Switzerland,0,0,1,1
2187,female,2012,Uzbekistan,0,0,1,1
2188,female,2012,Venezuela,0,0,1,1
2189,female,2016,United States,19,9,12,40
2190,female,2016,People's Republic of China,16,17,11,44
2191,female,2016,Great Britain,6,5,5,16
2192,female,2016,Russian Federation,4,11,10,25
2193,female,2016,France,4,3,6,13
2194,female,2016,Japan,4,3,4,11
2195,female,2016,Republic of Korea,4,0,1,5
2196,female,2016,Netherlands,3,2,3,8
2197,female,2016,Ethiopia,3,1,2,6
2198,female,2016,Australia,2,4,5,11
2199,female,2016,Spain,2,3,3,8
2200,female,2016,Italy,2,1,3,6
2201,female,2016,Canada,2,1,1,4
2202,female,2016,Czechia,2,1,1,4
2203,female,2016,New Zealand,2,1,0,3
2204,female,2016,Hungary,2,0,2,4
2205,female,2016,Democratic People's Republic of Korea,2,0,1,3
2206,female,2016,Lithuania,2,0,1,3
2207,female,2016,Romania,1,3,0,4
2208,female,2016,Ukraine,1,2,5,8
2209,female,2016,Cuba,1,2,1,4
2210,female,2016,Colombia,1,1,3,5
2211,female,2016,Jamaica,1,1,2,4
2212,female,2016,Poland,1,1,1,3
2213,female,2016,Serbia,1,1,0,2
2214,female,2016,Brazil,1,0,3,4
2215,female,2016,Kazakhstan,1,0,3,4
2216,female,2016,Chinese Taipei,1,0,1,2
2217,female,2016,Croatia,1,0,1,2
2218,female,2016,South Africa,1,0,1,2
2219,female,2016,Bahrain,1,0,0,1
2220,female,2016,Ireland,1,0,0,1
2221,female,2016,Slovenia,1,0,0,1
2222,female,2016,Switzerland,1,0,0,1
2223,female,2016,Tunisia,1,0,0,1
2224,female,2016,Germany,0,7,3,10
2225,female,2016,Kenya,0,3,3,6
2226,female,2016,Belarus,0,2,2,4
2227,female,2016,Bulgaria,0,2,0,2
2228,female,2016,Sweden,0,2,0,2
2229,female,2016,Mexico,0,1,4,5
2230,female,2016,Thailand,0,1,2,3
2231,female,2016,Azerbaijan,0,1,1,2
2232,female,2016,Slovakia,0,1,1,2
2233,female,2016,Denmark,0,1,0,1
2234,female,2016,Egypt,0,1,0,1
2235,female,2016,Finland,0,1,0,1
2236,female,2016,Indonesia,0,1,0,1
2237,female,2016,Türkiye,0,1,0,1
2238,female,2016,Belgium,0,0,2,2
2239,female,2016,India,0,0,2,2
2240,female,2016,Cameroon,0,0,1,1
2241,female,2016,"Hong Kong, China",0,0,1,1
2242,female,2016,Malaysia,0,0,1,1
2243,female,2016,Mongolia,0,0,1,1
2244,female,2016,Singapore,0,0,1,1
2245,female,2016,Tajikistan,0,0,1,1
2246,female,2020,United States,19,15,14,48
2247,female,2020,People's Republic of China,9,8,14,31
2248,female,2020,Japan,6,1,7,14
2249,female,2020,Netherlands,5,2,2,9
2250,female,2020,Hungary,5,1,2,8
2251,female,2020,Russian Federation,4,9,5,18
2252,female,2020,Great Britain,4,7,6,17
2253,female,2020,Republic of Korea,4,1,2,7
2254,female,2020,Spain,4,1,2,7
2255,female,2020,France,3,6,0,9
2256,female,2020,Kenya,3,3,1,7
2257,female,2020,Canada,3,1,5,9
2258,female,2020,Australia,3,1,3,7
2259,female,2020,Germany,2,4,3,9
2260,female,2020,Sweden,2,2,3,7
2261,female,2020,Colombia,2,1,1,4
2262,female,2020,Thailand,2,1,1,4
2263,female,2020,Jamaica,2,0,2,4
2264,female,2020,Croatia,2,0,1,3
2265,female,2020,Greece,2,0,1,3
2266,female,2020,Italy,1,5,2,8
2267,female,2020,New Zealand,1,4,2,7
2268,female,2020,Poland,1,2,2,5
2269,female,2020,Democratic People's Republic of Korea,1,2,1,4
2270,female,2020,Denmark,1,2,1,4
2271,female,2020,Ethiopia,1,1,3,5
2272,female,2020,Bahrain,1,1,0,2
2273,female,2020,South Africa,1,1,0,2
2274,female,2020,Brazil,1,0,2,3
2275,female,2020,Belgium,1,0,1,2
2276,female,2020,Chinese Taipei,1,0,1,2
2277,female,2020,Slovenia,1,0,1,2
2278,female,2020,Argentina,1,0,0,1
2279,female,2020,Kosovo,1,0,0,1
2280,female,2020,Puerto Rico,1,0,0,1
2281,female,2020,The Bahamas,1,0,0,1
2282,female,2020,Kazakhstan,0,2,6,8
2283,female,2020,Belarus,0,2,1,3
2284,female,2020,Mexico,0,2,0,2
2285,female,2020,Azerbaijan,0,1,3,4
2286,female,2020,Switzerland,0,1,2,3
2287,female,2020,Bulgaria,0,1,1,2
2288,female,2020,Cuba,0,1,1,2
2289,female,2020,India,0,1,1,2
2290,female,2020,Serbia,0,1,1,2
2291,female,2020,Venezuela,0,1,1,2
2292,female,2020,Burundi,0,1,0,1
2293,female,2020,Indonesia,0,1,0,1
2294,female,2020,Ireland,0,1,0,1
2295,female,2020,Mongolia,0,1,0,1
2296,female,2020,Philippines,0,1,0,1
2297,female,2020,Czechia,0,0,2,2
2298,female,2020,Egypt,0,0,2,2
2299,female,2020,Tunisia,0,0,2,2
2300,female,2020,Ukraine,0,0,2,2
2301,female,2020,Côte d'Ivoire,0,0,1,1
2302,female,2020,Finland,0,0,1,1
2303,female,2020,Islamic Republic of Iran,0,0,1,1
2304,female,2020,Israel,0,0,1,1
2305,female,2020,Portugal,0,0,1,1
2306,female,2020,Türkiye,0,0,1,1
